ibi	___ idem hispanice et valentiane est urbs hispaniae in provincia lucenti in fovea castallae cuius lingua principalis est sermo valentianus 
idus	___ iduum plurale tantum fem in fastis romanis erant dies mensis feriatus cum plenilunio antiquitus congruens mox tamen postquam annus ad cursum solis aptatus est non iam cum plenilunio congruens sed medio mense celebratus ita ut ceteris quidem mensibus tertius decimus mensibus vero martio maio iulio octobri quintus decimus dies in mense esset 
miranda	___ est persona comoediae the tempest a gulielmo shakesperio scriptae filia prospero qui olim dux mediolanensis iam in insula quadam exsul vivit 
gentium	___ typus elementorum quo gratis uti licet a victore gaultney creatus et condicionibus quibusdam publicatus est 
viridarium	___ est maior tractus viridis secundum praescripta artis hortulanae formatus qui decori otioque sit 
algebra	___ est disciplina mathematica quae quantitates abstractiter a perspectiva aequationes solvendi considerat 
hercules	___ graece heracles est heros mythologiae graecae iove et alcmena natus qui fortitudine omnes mortales superabat 
spurius	___ fuit praenomen virile romanum litteris sp notatum ab origine cognomen id quod adiectivum ___   qui non iustis nuptiis est procreatus illegitimus  
substantia	___ graece υποκειμενον   quod sub rem stat   etiam essentia appellata est ens materiae 
identitas	___ ab idem itas est eiusdem rei vel actus vel eventi repetitio si idem semper evenit ___ eventi est 
dies	___ est tempus quo planeta ulla praecipue tellus se vertit 
probus	marcus aurelius ___ sirmii hodie sremska mitrovica in serbia natus die 19 augusti 232 ibidem a militibus necatus anno 282 fuit ab anno 276 usque ad mortem imperator romanus 
universum	___ plerumque omnia quae exstant habetur res quae omnem materiam et spatium continet inter quam planetae stellae galaxiae res in spatio intergalactico contentae et omnis materia et energia 
iactus	___ seu jactus francogallice les gets est commune 1299 incolarum anno 2008 praefecturae sabaudiae superioris in franciae orientalis regione rhodano et alpibus 
amphitheatrum	___ graece amphi   circum   theatron   locus ad spectandum idoneus   est aedificium architecturae romanae antiquae ad munera et venationes adhibitum 
fora	___ theodisce föhr frisice feer danice før est insula in frisiae septentrionalis parte maris germanici slesvici et holsatiae pars 
tutor	___ est qui a iudice designatus hominis exempli gratia propter insanitatem aut senectutem hebetis et non apti pupilli negotios gerere debuit 
planities	___ sive campus in geographia est genus prominentiae terrestris constratum et clivibus humilibus praeditum 
populum	___ olim pagus fabianus alia nomina poperi populi italiane est urbs italiae et municipium circiter 5 250 incolarum in regione aprutio et in provincia aternensi situm 
blog	___ sive commentarii interretiales sunt ephemeris interretialis in qua auctores suis nominibus scribunt nec sub nomine maioris societatis 
cithara	___ graece κιθάρα est instrumentum musicum graeciae antiquae lyra familiae chordophonorum melius facta et sonata magis a professionalibus quam tironibus 
uxor	___ sive marita est consors muliebris in matrimonio cum alio homine coniuncta 
princeps	___ antique vocatur dux supremus civitatis cuiusdam hodierne appellantur principes in regnis filii regum reginarumve 
hora	___ spatium temporis definit quod 60 minuta proinde 3600 secundorum continet 
demographia	___ compositum ex vocibus graecis δῆμος   populus   et γράφειν   scribere describere   est scientia quae ratione statistica numerum incrementum ac structuram et spissitudinem incolarum prosequitur 
etymologia	___ a verbis graecis   verus   et   ratio   compositum est necessaria linguisticae historicae pars quae origines vocabulorum investigat 
lucius	___ fuit praenomen virile romanum littera l notatum fortasse a luce deductum ut scribit varro secundum hoc dicitur crepusculum a crepero id vocabulum sumpserunt a sabinis unde veniunt crepusci nominati amiterno qui eo tempore erant nati ut lucii prima luce in reatino 
aelius	___ fuit nomen gentilicium romanum hodie est praenomen masculinum italiane elio 
electronica	___ est disciplina physica quae onera fluentia in circuitibus electricis et novos modos onerum utendorum curat 
phonetica	___ graece φωνητική fere   ars vocalis   est studium orationis humanae et sonituum eius 
venti	in mythologia romana ___ quibus in mythologia graeca anemoi ἄνεμοι congruunt erant di ventorum quibus sua cuique regio et anni tempus propriumque caelum tributa erant 
singularis	___ rem unicam significat quae sui generis propriam qualitatem habet 
simon	___ seu simeon est praenomen biblicum originis hebraicae ש מ עו ן šiməʿōn a verbo ש מ ע šamaʿ   audiendo   deductum 
cellula	___ est minima pars vitae eucaryotum sive bacteriorum sive archaeorum et res quae omnes organismos notos efficit 
archaeologia	___ est scientia exstantium antiquitatum quae multum historiae auxilium confert 
americani	___ vel populus civitatum foederatarum sunt cives habitantes perennes et indi ___ civitatum foederatarum 
decennium	___ decem annus ium est spatium temporis inter decem circum solem orbitas telluris sive decem anni etiam 
pellicula	___ vel taeniola est opus artis cinematographicae quae consistit in sequentia imaginum photographicarum machina cinematographica exceptarum quae ope proiectoris cinematographici ostendi possunt 
sculptura	___ est inter bellas artes illa ars visualis qua artifices imagines trium dimensionum solidas sculpendo creant 
peruvia	___ plenius res publica peru est civitas sui iuris in america australi sita 
flavus	___ est color spectralis cuius undae longitudo praecipue inter 570 et 590 nm versatur 
areae	___ francogallice hyères occitanice iero est urbs parva et commune praefecturae vari in francia 
francia	___ rite respublica francica francice république française est terra in europa occidentali sita ac civitas sui iuris cui adiunguntur nonnullae regiones praefecturae et territoria transmarina in aliis continentibus et oceanis sita 
pila	___ vel si inflata follis est corpus congruenti cum forma plerumque sphaera saepissime in ludis adhibitum 
glossarium	___ est lexicon ad explicandum verba peregrina et vetera sive ratio verborum ad particularem dominimum scientiae pertinentium quae litterarum ordine disposita necnon explicatione aucta sunt 
syntaxis	___ graece σύνταξις a σύν cum una et τάξις ordo est studium et principiorum et regularum structurae ordinisque elementorum intra sententias in linguis sive naturalibus sive constructis sicut linguis programmandi 
pompeii	___ italiane sunt urbs italiae et municipium circiter 25 400 incolarum ad radicem montis vesuvii in regione campania et in urbe metropolitana neapolitana situm 
galli	___ fuerunt incolae galliae qui ipsorum lingua celtae latine ___ appellantur 
numerus	___ i m est conceptio quae finitam multitudinem ex unitatibus constitutam describit 
time	___ est libellus nuntiorum hebdomadalis ab anno 1923 in urbe novo eboraco impressus hodie etiam alibi londini titulo ___ europe hongcongi ___ asia sydnei ___ oceania 
augustana	___ italiane est oppidum italiae et municipium in regione pedemontio et in provincia cuneensi situm 
fabula	___ a fari sensu lato est narratio id quod in ore omnium versatur rumor populi sermo pervagatus res passim divulgata sive sit vera sive falsa 
mundus	___ sensu moderno est universitas rerum ad condicionem et cognitionem humanam essentialiter relatarum 
mens	___ est sentiendi et cogitandi apud hominem facultas qua res etiam ab omni materia abstractas percipimus et contemplamur 
marinum	___ seu fanum sancti marini italiane città di san marino est unum castellorum rei publicae sancti marini et eodem tempore urbs capitalis rei publicae omnis 
augustus	___ olim sextilis is m est mensis octavus in calendario gregoriano 31 dies habet 
palmae	___ italiane sunt urbes italiae et municipia circiter 18 900 incolarum in regione bruttio et in urbe metropolitana regina sita 
archaeologus	___ archaeologa est vir peritus mulier perita in scientia relictorum antiquorum archaeologia 
xaverius	___ est nomen masculinum ex vasconico etxe berri a   domus nova paterfamilias novus   deductum 
inflammatio	___ sive phlogosis sive phlogia seu phlegmone est corporis animalis accurate systematis immunitatis responsum ad infectionem aut irritationem 
fide	___ est abbreviatio collegi fédération internationale des échecs conditumque in lutetia
apollo	___ inis m graece apóllōn in mythologia graeca est filius iovis et latonae deli in insula natus 
basilius	___ i m est praenomen masculinum graecum graece βασίλειος scilicet latine regius 
aequum	___ bosnice est oppidum et municipium bosniae et herzegovinae in foederatione bosniae et herzegovinae et in pagus herzegovinae narentae situm 
morbus	___ i m vel aegritudo vel nosus e graece νόσος vel nusus est inopia sanitatis status abnormis qui corpus organismi adficit 
cutis	___ est systema integumentarium vertebratorum quod superficiem corporis tegit et multa alia officia perficit 
sacrificium	___ est victimas agendum pro divitate exempli gratia ___ in religione graeca 
unus	___ est numerus naturalis qui succedit zerum et antecedit numerum duo 
institutio	___ est ulla structura vel instrumentum ordinis socialis qui mores copiae singulorum intra commune datum gubernat qui res humana vel animalis esse potest 
enzymum	___ graece ἔνζυμον est molecula proteini quod reactionem chemicam et biologicam catalizat activando aut reprimendo 
apostoli	___ sunt duodecim viri ab iesu christo electi ex eius discipulis ut munus evangelii praedicandi et ecclesiae regendae haberent 
astronomia	___ graece   stella     lex   vel scientia sideralis est veterrima scientia naturalis summa omnium disciplinarum exactarum quae universum quod extra planetam nostrum est investigant 
ripa	___ in geographia est margo fluminis extremitas terrae quae aqua alluitur 
vexillum	___ est pars textus saepissime rectangularis vel aliter quadrilateralis cui sunt designatio coloresque distincti 
pictura	___ seu ars pingendi appellatur ars oculorum qua imagines duarum dimensionum creantur pigmento in tabulam vel chartam vel aliam materiam applicando 
biographia	___ lingua graeca antiqua βιογραφία vitae scriptio genus litterarum quod ad vitas singulorum hominum describendas spectat 
mas	___ aris m unde maritus sive masculus i sive sexus us m masculinus i est unus e binis sexibus quorum alter femineus est in quos permulta animantia dividuntur 
erythraea	___ tigrinyice ኤርትራ arabice إرتريا anglice eritrea sive rite civitas erythraeae tigrinyice ሃገረ ኤርትራ arabice دولة إرتريا et anglice state of eritrea est civitas sui iuris in cornu africae in africa boreorientali iuxta litus maris rubri 
unda	___ est fluctus vel fluctuatio vel conturbatio in substrato aliquo exempli gratia sonus in aëre fluctus in mari lux in vacuo 
propaganda	___ sc fides est notitia saepissime detorta et depravata quae ordine et composite divulgatur eo consilio ut magna hominum multitudo ad quidlibet credendum aut in desideratum modum cogitandi aut se gerendi adducatur 
usor	___ neolatine dici licet qui re quadam utitur sensu latissimo usus 
soror	___ est ea quae parentem communem vel parentes communes cum aliis liberis illius vel illiorum habet 
casa	___ est domus vilis tugurium mapale aedes deteriores et male constructae cuiusmodi sunt quas rustici et pauperes habitant et quas ita describit seneca 
fatum	___ proprie ac stricto sensu est dictum effatum quo quippiam futurum monstratur ut sunt oracula et responsa vatum a fari 
rosa	___ graece ῥόδον est genus lignearum plantarum perennium familiae rosacearum cui sunt plus quam centum species et milia cultivarietatum 
heraclius	___ i graece fuit imperator romanus orientalis a die 5 octobris 610 usque ad mortem die 11 februarii 641 
tigris	___ binomine panthera ___ est feles praedabundus maxima inter omnes feles secunda ad leotigrem hybridam 
binomen	___ aut nomen binominale est appellatio speciei in lingua latina botanica aut zoologica 
roma	___ est urbs in latio ad tiberim flumen sita caput latii atque italiae 
mensis	___ est mensurae spatium temporis in calendariis adhibitum qui primum in mesopotamia inventus adhibitusque est naturale temporis spatium ad motum lunae attinens in multis linguis nomina ___ et lunae sunt nomina cognata 
voluntas	___ est capacitas rationis vel conscientiae humana quae suas actiones dominari potest et bonum vel malum eligere potest 
abraham	___ vel abrahamus hebraice אברהם scilicet   pater multitudinis   graece aβραάμ cuius nomen natale fuit abramus est opinabilis religionum abrahamicarum patriarcha et eponymus inter quas iudaismus christianitas et islam 
altissimum	___ alia nomina altissimus italiane est oppidum italiae et municipium circiter 2 300 incolarum in regione venetia et in provincia vicetina situm 
bbc	___ pleniter british broadcasting corporation scilicet latine corporatio radiodiffusionis britannica est britanniarum televisio et radiodiffusio societas publica quae in totam britanniam gratia programmata transmittit terrestribus canalibus televisualibus octo 
irania	___ persice ايران api iːˈɾɑn etiam usitatissime ante annum 1935 persia ac rite appellata respublica islamica iraniae persice جمهوری اسلامی ایران jomhuri ye eslāmi ye irān est civitas sui iuris in asia occidentali sita 
rectum	intestinum ___ aut simpliciter ___ est pars finalis intestini accurate intestini crassi 
google	___ seu in colloquiis interretialibus forma vulgata gugula est publica corporatio in foederatis civitatibus americae et sua machina quaesitoria etiam appellata instrumentum exquisitorium guglianum quae paginas in tela invenit 
consilium	___ ut dicit forcellini est actus aliquid praecipue inter plures perpendendi proindeque deliberandi ac propterea in plurali numero interdum consilia significat sententias deliberationes 
epigramma	___ graece inscriptio initio fuit inscriptio sive in dono votivo sive in sepulcro vel artificio qua res finisque eius designaretur 
flumen	___ seu fluvius sive amnis est aqua quae inter duas ripas fluit 
subspecies	___ in classificatione biologica est categoria taxinomica post speciem ordinata 
aegyptus	___ lingua aegyptia antiqua km t coptice ⲕⲏⲙⲉ arabice مصر miṣr publice res publica arabica aegypti est respublica et civitas sui iuris praecipue in africa septentrionali sita cum paeninsula sinaitica ponte terreno ad asiam occidentalem ducente 
periegesis	___ vel philotheoria itineris faciendi voluptas est et omnia designat quae viator in itinere ad quendam locum dissimilem ei ubi habitat agit 
passus	___ est mensura longitudinis quinque pedum quae 1 metrum et 48 centimetra valet tamquam duos gradus 
tonga	___ tongane ___ sive regnum tongae vel regnum tonganum tongane pule anga fakatu i   o ___ anglice kingdom of ___ e nomine proto polynesico ___   meridies   est libera civitas insularis polynesia in oceano pacifico australi sita amplius 170 insulas divisas in praecipua archipelaga tria complectens et iacens tertia spatii parte a nova zelandia ad havaianas insulas ad orientem insularum vitiensiium circiter 650 chiliometra 
graecia	___ graece ελληνική δημοκρατία est civitas sui iuris in europa inter meridiem et solis ortum sita 
typus	___ graece τύπος   nota signum forma percutiendo seu pulsando impressa   est figura imago forma effigies cuiuscumque rei ex qua similia multa facile est efficere 
arca	___ est res servati cum operculo cacumine atque a temporibus antiquis fuit 
manus	___ est distale organum prehensile multis digitis praeditum ad finem antebracchii vel antemembri primatum sicut hominum panum et lemuroideorum situm 
populus	___ est coetus multitudinis hominum iuris consensu et utilitatis communione sociatus 
dannenberg	___ lat mons abietum oppidum saxoniae inferioris ad albim situm et pars circuli lüchow ___ est 
axioma	___ atis n ex graeco ἀξίωμα ἀξιόειν   dignus considerare   et   postulare   ἄξιος   libratum   seu sumptio onis f in logicis posteris proditis est propositio vel thesis non probata vel demonstrata sed vera in se habita ergo conceditur a principio sua veritas quae sic est incipium aliarum veritatum deductarum et conclusarum 
chirurgus	___ graece χειρουργός manu laborans sive chiriater graece χειριατρός fere medicus manibus curans seu medicus vulnerarius est medicus peritus in secando et resarciendo partem corporis sive hominis sive animalis 
florentia	___ italiane firenze est urbs italiae et municipium circiter 382 743 incolarum locus princeps regionis tusciae et caput urbis metropolitanae florentinae 
basilica	___ est genus aedificiorum primo a romanis antiquis excogitatum in quo res publicae et iudiciales diebus fastis agebantur 
maritus	___ nomen a vocabulo quod est mas deductum sive vir est coniunx virilis in matrimonio cum alio homine coniunctus 
clima	___ dicitur consuetudo status caeli super annis et decadibus qui ad quandam terrae regionem pertinet 
dialectos	___ vel dialectus graece est peculiaris loquendi ratio apud homines una eademque lingua utentes 
seminarium	___ est institutum erudiendos discipulos in theologia fere ut iis paret ad ordinationem cleri vel alium ministerium 
slovacia	___ plenius res publica slovacensis est mediterranea civitas sui iuris in europa media sita urbe capitali bratislavia 
85	annus domini aerae vulgaris ___ sive annus dcccxxxviii ab urbe condita domitiano augusto xi et t 
baptistae	___ sunt ecclesia christiana quae credentes immersione baptizat et plerumque in doctrina calvinisma est 
badenia	___ germanice baden fuit antiqua civitas germaniae quae nunc ad terram foederalem badeniam virtembergiam pertinet 
athenae	___ graece neograece αθήνα sunt et numero incolarum et area maxima graeciae urbs 
arbor	___ est planta perennis lignea plerumque definita cui sunt multi rami secundi supra solum in singulo cauli vel trunco principali sustentati cum certa dominatione apicali 
aurora	___ est tempus mane diei quo satis lucet ut corpora resque videas cum sol 6 gradi sub finiente lucet 
volapük	___ est lingua artificialis quam ioannes martinus schleyer sacerdos catholicus germanus anno 1880 excogitavit 
ferrum	___ est elementum chemicum cuius signum est fe et numerus atomicus 26 
insula	___ est quaelibet terrae subcontinentalis pars quae ab aqua cingitur videlicet in mari flumine lacu aestuario 
las	___ alia nomina lasa italiane theodisce est oppidum italiae et municipium in regione tridentino alta athesia tirole meridionali et in provincia libera bauzanensi alta athesia tirolis meridionalis situm 
honduria	___ seu hondura hispanice honduras est res publica in mesoamerica 
testa	___ est pars de vase fictili fracta ollae fictilis fragmentum 
vindobona	___ sive vienna theodisce wien hungarice bécs bohemice vídeň slovace viedeň ad danubium sita est caput austriae et simul una e novem civitatibus austriacis 
agricultura	___ sensu latissimo est summa omnium artium scientiarum et technologiarum quae de terris colendis et animalibus tractandis curant ut poma frumenta charas carnes textilia aliaeque res e terra bene producantur 
saxonia	___ est civitas foederata libera sita in parte orientali rei publicae foederatae germaniae 
murcia	___ murtia murgis arcilacis atque male vergilia hispanice ___ est urbs hispanica 442 203 incolarum ad seguram fluvium sita 
cena	___ est principale epulum quotidianum ab aliis circa meridiem ab aliis circa solis occasum sumptum 
frater	___ ex proto indoeuropaeo bhrā ter est aliquis generis masculini qui habet eosdem parentes ac ceteri eorum liberi 
aulus	___ rarius olus fuit praenomen virile romanum abbreviatio a quod georgius davis chase dicit a deminutivo quod est avulus aut ab olla esse deductum coniunctionibus cum etrusco avile et verbo alendo reiectis 
londinium	___ anglice london est urbs capitalis angliae et regni britanniarum omnis eodemque tempore maxima et frequentissima britanniae regio metropolitana atque maior industriae humanae sedes 
nix	___ est praecipitationis genus quod cum aqua in aere apud nubes provenit et infra congelatur 
socrates	___ graece philosophus graecus natus 469 a c n prope athenas filius sculptoris et obstetricis mortuus 399 a c n 
vectura	___ est motus viatorum et onerum e g mercimoniorum ab uno loco ad aliud 
suetonius	gaius ___ tranquillus communiter ___ natus anno circiter 70 mortuus anno incognito post 122 fuit eques romanus bibliothecarius eruditus linguis graeca et latina scriptor 
virtembergia	___ wirtemberga vel wurtemberga fuit antiqua germaniae civitas quae ab anno 1952 una cum badenia et zolnero est pars terrae foederalis badeniae virtembergiae 
hispania	___ hispanice sive regnum hispaniae hispanice est civitas sui iuris in paeninsula iberica parte europae occidentalis ubi lusitania quoque est 
mauritius	___ sive mauricius est nomen masculinum amplificatio verbi latini   maurus   qui venit de verbo graeco maurós niger 
vis	___ is f sensu latissimo res efficiendi potestas sive inclinatio vel virtus vel coercitio est 
protestantes	notio ___ quae in primo politica fuit sensu strictiore omnes assectatores communitatum christianarum quae reformatione saeculo decimo sexto ortae ex germania helvetiaque profectae primo imprimis in europa meridiana septententrionalique diffusae sunt 
hereditas	___ nihil aliud est quam successio pecunia res mobiles res immobiles etiam aes alienum in universum ius civile quod defunctus habuit 
chirurgia	___ graece χειρουργία   ars manu facta   est ars morborum et vulnerum curandorum et sanandorum ita ut chirurgus corporis membra sanaret exempli gratia cancrum secaret et e corpore removeret 
sahara	___ seu zaara arabice الصحراء الكبرى aṣ ṣaḥrā al kubra est maxima orbis terrarum calida regio deserta et altera ab antarctica 
mexicum	___ a vocabulo navatlaco mēxihco hispanice méxico seu plena appellatione foederati status mexicani est foederata respublica constitutionalis quae populari ratione gubernata ex parte meridiana americae septentrionali finitima ex triginta duabus civitatibus foederatis composita 
valentia	___ vulgo valència est urbs hispaniae circiter 808 000 incolarum caput homonymae provinciae et communitatis valentianae 
sacerdos	___ est homo cuius officium vel munus est ritus religiosos celebrare vel fungi maxime victimam vel hostiam mactare et diis aut deo donum offerre 
robertus	___ est praenomen virile francogallicum originis theodiscae a vocabulis protogermanicis quae sunt χrōþi   fama   et berχta   lucidus   deductum 
civitas	___ appellatur quaequam communitas politica quae proprium ius et regimen habet 
iuppiter	___ graece gen est deus maximus romanorum rex deorum ___ est deus caeli fulminisque et saturni filius qui in olympo monte domum habebat 
ora	___ est locus apud mare sive lacum situs qui in arena plerumque consistit 
cognitio	___ a co n gnōscō cognato verbi graeci γιγνώσκω   scio percipio   cf γνῶσις   ___ scientia   est copia omnium ingeniorum et rationum ad scientiam pertinentium inter quas sunt attentio memoria et memoria fungens iudicium et aestimatio ratiocinatio et computatio solutio quaestionum et decernere comprehensio et lingua producta 
transsilvania	___ dacoromanice ardeal sive transilvania hungarice erdély theodisce siebenbürgen olim magnus principatus et pars regni hungariae erat ab anno 1920 exceptis annis 1940 1944 ad romaniam pertinet 
emeritus	___ ppp verbi emerere sive emereri forma adiectiva tituli in usu est ad professorem episcopum vel hominem alterius professionis significandum cui otium permissum est 
arma	___ sunt instrumenta bellica sive ad tegendum sive ad nocendum 
arx	___ arcis fem est castrum vel supra urbem vel etiam intra urbem editum natura et opere munitissimum de quo paucorum hominum praesidio hostes numero plures arceri possunt 
carolus	___ est nomen masculinum vel a nomine germanico praesertim francico karl quod virum significat vel a verbo etiam germanico heri quod peditum aut exercitum significat derivatum 
metallum	___ est genus materiae quod lucem refulget ac eam defert propriam colorum ratio metallica dicta 
otto	___ est nomen masculinum a praefixo nominum germanicorum ot sumptum velut in otfrido othocaro otmaro quo opes vel bona significantur 
gubernator	___ a gubernando est plerumque singulus praefectus publicus cui est potestas gubernationis partis exsecutivae subnationalis vel non sui iuris gubernatae sub capite civitatis stans 
rectio	___ seu gubernatio est institutum quod civitatem regit ius dicens leges faciens et pacem vi imponens 
lingua	___ est humana multiplicum communicationis systematum discendorum et adhibendorum facultas qua sententiae inter homines mittantur et intelligantur 
ferrivia	___ vel via ferrata est orbita plerumque in binis regulis chalybeis consistens quae paribus intervallis inter se distant et trabibus conexae sunt 
commercium	___ dicitur voluntaria rerum commutatio traditio aut cambitas inter homines 
autocinetum	___ i n autoraeda ae f autocurrus us m vel currus automobilis vel ipsomobile est vehiculum cum rotis primum quattuor in usu celeriter populos ad alios locos transportare 
mel	___ lis n est cibus dulcis ab apidis ex nectare florum factus 
nox	___ est spatium temporis quod inter occasum post vesperem et ortum solis cadit 
mauri	___ a verbo punico mahourim   occidentales   vocati fuerunt populus africae septentrionalis inter carthaginem et oceanum ubi mauretania romana provincia sita est 
patria	___ est vel civitas vel terra vel natio attributionis cuius hominis cui indigenae favent sed cicero scripsit pacuvium dixisse 
observatorium	___ est locus instrumentibus ad phaenomena terrestria ac caelestia observanda instructus 
gens	___ est conlectio vel societas humana qui sibi agnoverunt et fere credunt se e stirpe eadem ortos esse smith 1986 
blues	___ est genus musicum in meridiei profundi regionibus civitatum foederatarum exeunte saeculo undevicensimo ortum 
utc	universale tempus coordinatum sive ___ est tempus in longitudine geographica zero hoc est tempus grenovici in meridiorientali londinii districtu observatum 
litterae	___ sunt artes scriptoriae quae in formam librorum epistularum multasque alias formas redactae vel docendi vel delectandi causa in medium proferuntur 
theologia	___ a verbo graeco θεολογία θεός   deus   λόγος   verbum     dictum   est systematicum rerum divinarum studium 
liberi	___ in consuetudine romana proles dicuntur quae e coniugio legitimo viri feminaeque liberae ortae sunt 
lectio	___ a legendo vel schola est introductio verbo tradita ad praebenda data vel docere homines de certa re exempli gratia magister in universitate vel collegio 
bomba	___ ae f seu pyrobolus i m e verbo graeco   telum igniferum   est machina bellica quae dissiliendo potentissimam energiae undam emittit vicinaque omnia delet 
hostis	___ ut scribit aegidius forcellini lexicographus italus est is cum quo publice bellum habemus 
oleum	___ est adeps liquidus ex oleis extractus aureum fluidum appellatus 
vasconia	___ vasconice euskadi hispanice país vasco antea provincias vascongadas est communitas autonoma hispanica quae provincias alavam biscaiam et ipuscoam etiam territoria historica nuncupatas comprehendit 
donaldus	___ est nomen virile anglicum origine scoticum gadelice domnhall a dumno   mundus   et val   regnum   hoc est   rex mundi   
divortium	___ est dissolutio matrimonii vel unionis maritalis atque abolitio et aut denuo constitutio officiorum et curarum legitimarum matrimonii ergo vincula matrimonii maritorum sub lege eorum civitatis dissolvens 
stella	___ vel astrum vel sidus est sphaera gasii gravitate retenta quae energiam fusione nucleari generat 
fundus	___ est ager vel terra ubi pecus alimentum educatur aut ager qui colitur et aratur et posterior segetem misit et frumentum colligit alimentum pabulumque qualiter res rustica et agricola 
somnium	___ est series imaginum idearum animi motuum et sensuum qui sine voluntate in mente per certos somni gradus fiunt 
monstrum	___ i n nomen tractum ab eadem radice ac verbum   monere   significat omen a deis ut saepe putatur missum vel rem abominandam ut vitulam bicipitem 
eugenius	___ graece εὐγένιος a vocabulo εὐγενής   nobili genere natus   est praenomen virile a pluribus antiquis sanctis christianis gestum quorum notissimus fuit ___ episcopus carthaginensis saeculi v 
homerus	___ graece hómēros in fama classica occidentali est auctor iliadis de ira achilleos rebusque anno belli troiani decimo gestis et odysseae de errationibus ulixis redituque in ithacam ac ceterorum operum minorum maximus poeta epicus graecus existimatus 
lucii	___ seu thebae alia nomina castrum ___ in valle gratis italiane sunt oppida italiae et municipia in regione bruttio et in provincia consentina sita 
amor	___ est animi adfectus quo homo ad hominis alterius desiderium commovetur 
cauda	___ seu coda seu penis est pars finalis animalis corporis quae non solum in vertebratis sed etiam in nonnullis invertebratis exempli gratia scorpionibus et collembolis invenitur 
columbia	___ hispanice colombia et sollemnius república de colombia est boreoccidentalis res publica in america meridionali 
sapientia	___ est facultas cogitandi et agendi per scientiam experientiam intellectum prudentiam et aestimationem 
systema	___ graece σύστημα formatum compositum coniunctum significat elementa ita composita ut extrinsecus visa totalitas sint proposito seu consilio unitata et vi mutua coniuncta et ita adversus extranea definita 
mixtura	___ seu mistura in chemia est quod provenit cum duae aut plures materiae chemicae nulla reactione chemica intercedente miscentur 
visus	___ seu visio est sensus videndi perceptio rerum externarum ab oculis effecta interpretatio lucis visibilis 
origines	___ est opus historicum de civitatibus italiae a catone maiore scriptum hodie in fragmentis servatum 
norvegia	___ plenius regnum norvegiae norvegice norge bokmål et noreg nynorsk est civitas maxime septentrionalis in scandinavia 
camera	___ ae f graece καμάρα sive concameratio est tectum conclavis arcibus vel fornicibus factum ut sit convexum cameratum sive arcuatum seu testudinatum 
australia	___ anglice titulo pleniore commonwealth of ___ est monarchia constitutionalis in hemisphaerio australi sita quae in continente australiana insula tasmania et multis insulis minoribus in oceanis indico et pacifico consistit 
statistica	___ seu modo graeco statistice est scientia eorum qui res examinant quoad de magnis multitudinibus agitur 
horae	___ graece deae sunt quae horis praesunt iovis ac themidis filiae apud mythologos communiter tres ___ sunt tribusque temporibus anni respondent 
ruina	___ est aedificium quod vel vi bellorum vel aliis causis corruptum est aut per se muris et tectis fractis et contusis ruit 
aemilia	___ italiane est historica terra italiae et pars regionis administrativae aemiliae romaniae quae hodierna regio divisa est in partes duas aemiliam et romaniam vel romandiolam 
veteri	___ alia nomina casalis veteris italiane sunt oppida italiae et municipia circiter 8 300 incolarum in regione campania et in provincia salernitana sita 
suburbium	___ est regio urbana olim extra moenia sed nunc longe a media urbe sita 
leo	___ compendium nominis anglici link everything online scilicet omnia in interrete conectere est situs interretialis qui complectitur 
symphonia	___ e verbis graecis σύν   cum coniunctus   φωνή   sonus vox   in musica classica occidentali est extenta compositio musica paene semper pro orchestra composita 
astrologia	___ est ars ex astris interpretandi cuius momenti sit quoddam tempus 
cladus	___ e graeco κλάδος   ramus   etiam grex monophyleticus appellatus in phylogenesi est grex organismorum qui tamquam ramus arboris vitae est atavum omniaque huius prognata communia continens 
sella	___ est supellex in qua homo sedere potest cui sunt pars librata sedes et plerumque quattuor pedes 
hannibal	___ barca punico natus anno 247 a c n mortuus anno 183 a c n praeclarus dux punicus bellum cum populo romano gessit quod a posteris secundum bellum punicum appellatum est 
antipapa	___ est qui contra alium papam secundum ius canonicum electum episcopus romanus creatus est quia cardinales divisi sunt aut quia imperator aut familiae nobiles romanae contrapapam imposuerunt 
caro	___ carnis f est corpus cuiuslibet animalis quae pro cibo est 
dubium	___ est status ubi mens inter binos propositiones contradictorias suspensus manet utro annuere nequiens 
litus	___ est finis maris vel oceani regio continentis vel insulae ubi aqua et terra conveniunt vel linea quae fines terrae et oceani vel lacús est 
commeatus	___ us m vel ___ vehicularis est omnium generum vehiculorum motus in viis suis in terra superficie et sub aquae et aere atque personae vadentes in viis 
energia	___ in physica est captus vel potestas laborem agendi quae aequalis est vi in corpore adhibita a motionis distantia multiplicata 
apostolus	___ graece   ille qui est dimissus   est nuntius vel legatus 
convivium	___ est celebratio vel hominum conventus quo cena vino vel cerevisia colloquio iocis frui communiter 
fasti	romae ___ orum vel fastus uum erant calendarium a pontificibus confectum in quo indicabantur non tantum kalendae nonae idus et nundinae sed etiam quo die ius dici posset dies fastus quo die non posset dies nefastus diis sacratus quo die comitia haberi fas esset dies comitialis ac nonnulla eventa insignia 
fiat	___ vel fabbrica italiana automobili torino latine italica productio autocinetum augustae taurinorum est longe maxima societas ad autocineta facienda in italia 
domus	___ est aedificium vel structura quae ab hominibus vel aliis animalibus habitari potest 
protocollum	___ vel protocolum apud hoffman est vocabulum latinum anno 1535 illatum a graeco πρωτόκολλον   protokollas   πρῶτος   primus   κόλλα   gluten   derivatum indicans folium vel paginam vel appendiculam adhaesam involuto papyraceo manuscripto cum descriptionibus de materia contenta 
archiepiscopus	in christianitate ___ ex graeco αρχι   primus   επισκοπος   inspector     custos   est episcopus elatus 
diogenes	___ est nomen graecum quo complures viri illustres appellati sunt 
ens	___ in philosophia metaphysica est notio latissima quae obiectivas et subiectivas realitatis et exsistentiae proprietates amplectitur 
architectura	___ a graece αρχιτεκτων ab αρχι   dux   τεκτων   aedificator   est ars scientiaque adumbrandi aedificandique aedificia 
afgania	___ sive afghanistania afganice et dari افغانستان est civitas sui iuris in media asia sita quam turcomannia uzbecia tadzikistania sinae pakistania irania circumdant 
latini	___ inter gentes italicas numerantur quae stirpe indoeuropaea ortae ex balcania secundum oram hadriaticam migrantes posteriore aetate aënea 1200 900 a c n in italia consederunt 
iuno	___ fuit maxima dea romana quae multis muneribus fungebatur nam erat dea matrimonii partus atque omnino feminarum quae ut viri per genium suum sic per iunonem suam iurabant 
legatio	___ est globus hominum a civitate aut ab organizatione internationali intergubernativa velut consociatione nationum publice missorum qui adest in alia civitate aut organizatione intergubernativa ut repraesentetur missionis civitas aut organizatio in civitate destinationis 
pompa	___ est ostentatio qua vel electi vel multitudo hominum certum spatium procedunt ut exempli grati diem festum agant victoriam celebrent mortuum ___ funebri efferant 
cinematographia	___ ars visualis qua photogrammata tam celeriter et continenter proiecta sunt ut fiant motus praestigiae est 
pronuntiatus	___ seu appellatio locutio vox et vocis sonus est modus quo homines lingua utuntur ut confabulentur a sono 
centum	___ numeris arabicis 100 romanis c est numerus naturalis et par inter 99 et 101 qui in factores primos 2 5 resolvitur 100 seu 10 est numerus quadratus perfectus etiam summa est duorum numerorum quadratorum 6 8 
marchia	___ lingua germanica alta mediae aetatis marc march quod est limes terminus lingua latina margo et dicit in medio aevo territorium marginalem imperii quod territorium contra peregrinos populos defendendum erat 
pagina	___ est una inter duas facies folii inscribendi libri e paginis chartaceis saepius constantur 
pakistania	___ urdu pākistān est res publica in asia prope terram antiquam cui nomen latine   sindus   et graece sindhos fuit 
aquatica	___ orum n sunt loci uliginosi genus in quo dominantur herbacearum plantarum species potius quam plantae lignosae 
vicarius	___ in ecclesia anglica vulgo dicitur presbyter paroecialis videlicet is qui beneficium paroeciale tenet 
puteus	___ est cavum in terra fossum ad aquam obtinendam praecipue significat foramen directum rotundumque muris caementiciis praeditum ad altitudinem aquae subterraneae immersum 
parietes	___ parentium alia nomina parentes paretis italiane sunt oppida italiae et municipia in regione bruttio et in provincia consentina sita 
cyprus	___ graece κύπρος turcice kıbrıs sive res publica cypria graece κυπριακή δημοκρατία turcice kıbrıs cumhuriyeti est civitas et insula iuxta asiam occidentalem in mari mediterraneo orientali iacens sed politice inter civitates europaeas numerata quamvis cum disceptationibus 
exsistentia	___ generaliter habetur illud quod vere perseverat praeter praesentiam sui 
bono	___ nomine proprio paulus david hewson natus 10 maii 1960 eblanae in hibernia est musicus hibernicus et cantor gregis musici u2 
cancer	___ cancri m est quodlibet multorum crustaceorum decapodorum infraordinis brachyurorum graece βραχύ   brevis   ουρά   cauda   cuius plurima habent brevissimam caudam vel abdomen reductum et omnino sub thorace celatum 
india	___ hindi भ रत seu plenius भ रत गणर ज य res publica ___ est civitas sui iuris in asia meridiana sita septima mundi civitas quod ad superficiem pertinet ad numerum civium altera et inter res publicas democraticas prima 
proverbium	___ sive adagium est dictum simplex et solidum populo notum crebroque iteratum quod veritatem in communi sensu vel in activa experientia humana conditam saepe per metaphoram declarat 
opium	___ creatur ex seminibus generis papaveris praecipue e p somnifero et est medicamen quod facere potest homines non iam sui iuris esse et aegros fieri 
propheta	___ hebraice נבי nābī graece προφητης est qui secundum religionem nuntium dei supernaturalis aut alius divinitatis per visionem auditionem aut in somno accipit vel futura praenoscenda et populo affert 
veritas	___ est id quod cum eis rebus quae sint seu cum rerum natura congruit et quod falsitati opponitur 
avium	___ italiane est oppidum italiae et municipium in regione tridentino alta athesia tirole meridionali et in provincia libera tridentina tridentinum situm 
cancellaria	___ alia nomina cancellarium italiane est oppidum italiae et municipium in regione lucania ac in provincia potentina situm 
iamaica	___ anglice jamaica est insularis civitas in mari caribaeo antillarum pars cubae meridie et hispaniolae haitiano respublico dominicani territorii occidente sita 
thessalia	___ graece est regio antiquae graeciae quae circiter eosdem limites habebat atque peripheria hodierna 
comitatus	___ us m in origine iam ad finem imperiii romani iurisdictio comitis fuit 
rus	___ est area relative paucorum incolarum generatim agriculturae dedicata significatione urbi opposita 
aurum	___ est elementum chemicum quod numerum atomicum 79 et signum chemicum au habet 
aeneas	___ troianus graece αἰνείας in mythologia romana est veneris et anchisae filius cuius uxor creüsa filia priami hecubaeque et soror hectoris ei ascanium peperit 
regna	___ dacoromanice reghin hungarice szászrégen theodisce sächsisch reen sive sächsisch regen est urbs transsilvaniae romania in comitatu marosiensi flumini mariso adiacens 
fluxus	___ a fluendo vel plenius motus ___ est internationalis artificium scriptorum compositorum et designatorum motus avant garde qui primum decennio 197 ob varia media artesque mixtas innotuit 
conclave	___ is n e vocabulis cum clave est in primis pars domus velut cubiculum quae ut e nomine patet clave clauditur deinde conventus collegii cardinalium ecclesiae catholicae ad papam eligendum cuius rei gratia recentioribus temporibus plerumque cardinales in sacellum sixtinum ad deliberandum secedunt 
pulsus	___ sive ___ arterialis est in medicina palpatio cycli cardialis 
servus	___ est homo inter alterius hominis bona possessus plerumque homo cuius labor servitute adsumitur 
anatomia	___ sive anatome sive anatomica sive anatomice a graeco   dissectio   est scientia membrorum corporis 
fano	___ fidei scutum epistula ad ephesios 6 16 qui ecclesiam catholicam tuetur effignit id est summi pontificis auctoritas idem effingit 
polis	___ graece est notio propria graecae civilizationi de re urbana quae attinget ad urbem civitatis 
uraquaria	___ sive uruguaia hispanice uruguay seu plenius república oriental del uruguay est civitas sui iuris et res publica in americae australis austrorientali parte sita 
petrus	simon ___ mortuus fere anno 65 erat unus ex duodecim apostolis qui iesum nazarenum dum vivebat secuti sunt 
symbolum	___ a graeco σύμβολον   tessera signum pactum   vel symbolus signum est ex quo quid cognoscitur atque aliam rem repraesentare intellegitur 
stipula	___ in botanica est pars extrinsecus crescens in ambobus basis petioli lateribus 
plebs	___ bis plebeius i erat vulgus rei publicae romanae quae classi ad nobiles sive patricios sive patres non pertinebat 
amicitia	___ est mutuus benevolentiae amor et utrinque manifestus qui bonorum communicatione omnimoda fundatur 
numen	___ est in religione romana dei nutus quae adflatum divinum sive voluntatem dei cuiuspiam indicare credebatur 
atollum	___ i n est marina curalii insula quae lacunam partim aut omnino circumplectitur 
rivi	___ francogallice rieux volvestre usque ad diem 22 iunii 2009 simpliciter rieux gasconice rius est commune francicum 2 595 incolarum anno 2012 praefecturae garunnae superioris in regione australi meridiano et pyrenaeis a die 1 ianuarii 2016 occitania ruscinone meridiano et pyrenaeis 
discipulus	___ nominatur qui magistrum quendam sequitur et discit scientiam suam 
nicola	___ est praenomen femininum et masculinum origine graeca italis etiam masculinum vide nicolaus 
mammalia	___ sunt classis animalium vertebratorum quae habent glandulas mammales quibus feminae lac faciunt et partûs nutriunt neocorticem regionem cerebri pilos vel comas ac tria ossa mediae auris 
ager	___ agri m est terra aut saepta aut non ab hominibus culta ut fruges hoc est frumentum vinum oleum et cetera ferat vel ut saeptum pecorum sit 
ecclesia	___ christiana a graeco   evocatio   est communio fidelium vel et domus eius in cuius nomine conveniunt fideles 
vallum	___ est muri genus circum castra oppidum et caetera instructum munimenti causa ex serie sudium trabum lignorumque in terra conditis 
physiologia	___ graece φυσιολογία   studium naturae   est scientia naturalis quae corporis munera investigat in animantibus i e animalibus homine sapienti incluso et plantis 
seditio	___ est motus populi imperium detrectantis vel inter se certantis aliis verbis dissensio turba discordia in civitate facta 
texia	___ seu civitas texana anglice plene state of texas est civitas civitatum foederatarum americae secunda sive quod ad incolas sive quod ad superficiem pertinet et vicina nationi mexico 
gana	___ anglice ghana publice republic of ghana   res publica ganensis   est civitas africana incolis numero 24 339 838 anno 2010 cuius caput est urbs accra 
gualterius	___ est nomen masculinum quod   ducem   significat a germanico walda   vis   waltan walten   imperare   et harja   exercitus   
guiana	___ sive guyana anglice plene co operative republic of guyana res publica cooperativa guyana est civitas in america meridionali quae olim accurate ab anno 1835 usque ad annum 1966 colonia imperii britannici et ___ anglorum vocabatur 
theoria	___ graece θεωρία   adspectus   in philosophia et scientia appellatur certa ratio quae experimentis et obervationibus extensis vera esse demonstrata est 
antarctica	___ est australissima continens telluris quae geographicum polum australem superiacet 
microsoft	___ est maxima societas mercatoria americana quae programmata computatris operandis fabricat 
eos	___ graece vel latine pure aurora est dea aurorae in mythologia graeca 
adiectivum	___ rectius nomen ___ est nomen quod alteri nomini subiungi vel adici potest unde vocabulum ipsum tractum esse videtur 
buffalo	___ est urbs in civitatibus foederatis americae accurate secunda quod ad incolas pertinet in civitate novo eboraco 
instrumentum	___ sensu antiquo est copia et apparatus earum rerum sine quibus tueri aut exercere quippiam non licet supellex 
herba	___ est planta vel edenda et adhibita quasi condimentum in rebus culinariis aut quasi medicina quae crescit aut manu curaque hominis aut cura naturae 
proconsul	___ is m erat in re publica romana consul cuius imperium ultra spatium unius anni prorogabatur 
hantonia	___ anglosaxonice hamwic et hantune sed hodie vulgo southampton est urbs angliae e qua comitatus hantoniensis nuncupatur 
helena	___ graece ἑλένη in mythologia graeca fuit uxor et menelai regis lacedaemonis et paridis principis troiani ː ob rivalitatem inter binos viros causa belli troiani fuisse dicebatur 
sudania	___ plenius res publica sudanensis seu sudaniensis est civitas sui iuris in africa cui 27 420 000 incolae sunt 
ianus	___ iani m fuit maximus et antiquissimus romanorum deus cui nullus graecus deus similis repertus est ianuis enimvero et omnino transitibus principiisque praeerat 
histrio	___ vel actor est artifex qui personam quam credibilissime atque sincerissime gerat sive in theatro sive in pelliculis 
privilegium	___ privus et lex sc res legi privae est exceptio legum singulis aut certo ordini aut turmis civium data qua iis erga ceteros commoda attribuuntur 
later	___ est talea ceramica ex argilla cocta facta qua aedes erecti sunt 
ulixes	___ graece odysseus fuit heros mythologicus graecus rex ithacae cuius gesta in bello troiano a poeta iliadis cantantur 
officina	___ etiam sedes officii dicitur quisque locus ubi homines officio quoddam funguntur potest esse 
madagascaria	___ olim insula delphina est insula et civitas in oceano indico ad africam 
volumen	___ est liber et ab origine liber praecipue e charta papyracea facta quod volutum est 
testamentum	___ est instrumentum legitimum quo homo suam ultimam voluntatem de distributione post mortem suorum bonorum pecuniaeque declarat 
familia	___ in contextu humana est grex singulorum qui consanguinitate adfinitate vel domicilio coniuncto adligantur 
inventum	___ est aliquid novi ab homine factum vel apertum quod nemo antea fecerat aut noverat 
articulus	___ sive articulatio graece ἄρθρον est locus ubi plura ossa colliguntur 
catalaunia	___ sive catalonia catalane hispanice aranice comunautat autonoma de catalonha est communitas autonoma hispaniae quae finibus habet ad septentrionem francogalliam et andorram aragoniam ad occidentem et regionem valentianam ad meridiem 580 km litoris ad mare mediterraneum 
alexis	___ graece ἄλεξις est nomen a verbo graeco ἀλέξω   defendo   deductum 
virginia	___ rite res publica virginiae pro regina elizabetha prima cognomine virgine regina nuncupata est civitas in civitatibus foederatis americae una ex tredecim coloniis americanis quae in imperium britannicum per res novas americanas surrexerunt 
fasces	___ nomen plurale sg fascis sunt insignia imperii e virgis et securi fascibus colligatis facta 
amadeus	___ a verbis amando et deo est praenomen virile mediae latinitatis fortasse ex nomine graeco theophilo translatum 
castrum	___ sensu latissimo est omnis locus munitus sive de turribus singulis aut de ingentibus fortalitiis stellaribus vel sive de antiquis arcibus aut inmanibus consaeptis militaribus hodiernis agitur 
160	annus domini vel annus aerae vulgaris ___ clx sive annus 913 ab urbe condita fuit annus intercalarius kalendarii iuliani in quo 1 ianuarii fuit dies lunae 
pluralis	___ est res grammaticae quae significat multas res referri est numerus grammaticus 
textum	___ sive textile scilicet   opus   ambobus ex verbo texo deductis est materia flexibilis per textrinum filorum ex animalibus plantis mineralibus fabricata 
philippus	___ est nomen masculinum de graeco philippos φίλιππος de philos φίλος amicus et hippos ίππος equus ergo amicus equi sive equorum 
mythistoria	___ vel fabula milesia fabula romanica fabula romanensis est liber qui longam enarrat fabulam in litteraria soluta oratione hoc est non versibus scriptam 
duodecimum	___ italiane est oppidum italiae et municipium in regione pedemontio et in provincia astensi situm 
borussia	___ sive prussia theodisce preußen est nomen historicum terrarum europae orientalis mediaeque significans 
archidioecesis	___ est dioecesis cuius episcopus qui dicitur archiepiscopus metropolita provinciae ecclesiasticae est 
pactio	___ vel foedus vel conventio est ius inter civitates et gentes a pacto inter plus quam duas civitates vel organizationes formautur 
datis	___ persice dâtish graece δατις fuit dux bellorum medus saeculi quinti a c n 
frequentia	___ aetate ciceronis id solum significabat quotiens locum quendam visitaret vel multitudo vel turba et solum vocabulum crebritas ea aetate significabat quotiens res quaedam repeteretur 
febris	___ est incrementum corporis caloris in hominibus super 37 gradus propter alacritatis glandulae hypothalami mutationem 
democratia	___ graece δημοκρατία ex δῆμος   populus   κρατία   imperium   est modus reipublicae regendae vel forma administrationis quo potestas gubernandi ex populo nascitur aut recto referendo ___ recta aut per legatos a populo electos ___ repraesentativa 
interpres	___ vel metaphrastes est qui sermonem aut orationem aut gesticulationem intellegibilem reddat inter duas vel plures partes quae diversis linguis utuntur 
oecologia	___ a graeco οἶκος   domus   λόγος   ratio   est studium scientificum organismorum qualem vim inter se habeant ac quomodo loca circumiacentia afficiant iisdemque in vicem afficiantur 
basic	___ est lingua programmandi cuius varietatem primam annoioannes kemeny et thomas kurtz universitatis derstemutae professores 1963 excogitaverunt 
necessitas	___ est vis qua cogimur aliquid facere aut omittere fatum necessitudo propositio si deficere non potest necessaria esse dicitur 
coniectura	___ in arte mathematica est enuntiatum quod volumus demonstrare nescimus utrum verum an falsum sit 
binos	___ est commune francicum 42 incolarum anno 2012 praefecturae garunnae superioris in regione australi meridiano et pyrenaeis a die 1 ianuarii 2016 occitania ruscinone meridiano et pyrenaeis 
sa	___ abbreviatio sturmabteilung vocabuli theodisci   divisio oppugnatoria   fuit grex quasi militum quo nsdap et adolphus hitler annis rei publicae vimarianae contra inimicos nazistarum utebantur 
pontum	___ alia nomina vicus pontis pons in valle tellina italiane est oppidum italiae et municipium circiter 2 300 incolarum in regione langobardia et in provincia sundriensi situm 
folium	___ in botanica est plantarum organum quod respirationem per stomata et photosynthesim chlorophylli gratia perficit 
quaestor	___ fuit reipublicae romanae magistratus qui rebus fiscalibus militaribusque reipublicae praesideret 
iter	___ gen itineris n ut scribit forcellini est actus eundi profectio dicitur de brevi ambulatione vel saepius de profectione in longiquas regiones quae vel a privatis hominibus vel ab exercitu fiat 
dalmatia	___ alia nomina delmatia croatice italiane est regio antiqua europae hodie inter croatiam bosniam et herzegovinam ac montem nigram divisa 
caput	___ graece κεφαλή est pars in homine suprema corporis in qua sita sunt os aures oculi nasus cerebrum cerebellum etc 
agnomen	___ ad nomen est nomen proprium in vicem alii nominis aut praeter aliud nomen alicui homini datum 
castella	___ hispanice castilla est regio hispaniae sita inter cantabriam et saltus castulonensis fere planitia centralis hispanica 
titulus	___ est nomen honoris dignitatisve quod munus gradum seu ordinem alicuius hominis denotat 
berna	___ germanice bern francogallice berne est urbs circiter 123 000 incolarum in helvetia sita et caput pagi bernae atque confoederationis helveticae 
pluvia	___ est aqua liquida sub forma stillularum quae se ex atmosphaerico vapore aquatico concrescunt et tum praecipitant hoc est quae tam graves fiunt quam sub gravitate cadere possunt 
turris	___ appellatur omne aedificium aut pars aedificii quod multo altius est quam latum 
vero	___ alia nomina veronus verronius vevronus italiane est oppidum italiae et municipium in regione pedemontio et in provincia bugellensi situm 
oeconomica	___ est scientia quae omnes res oeconomicas investigat sicut pecuniam merces rerum fabricationes industrias commercium operationes benevolas negotiationes apparitiones et argentarias 
44	___ fuit annus bisextilis calendarii iuliani die mercurii incipiens annus consulatus crispi et tauri sive annus 797 ab urbe condita 
vena	___ sive phlebs graece φλέψ gen φλέβος est vas sanguineum quod sanguinem ad cor versus fert 
auxilium	___ est quidquid alteri adjicitur ad opem eidem ferendam adiumentum subsidium 
ideologia	___ graece ἰδεολογία   dogma de cogitationibus sententiisque   est una ex multis cogitationibus sententiisque de universo mundi vel earum rerum systematibus 
nympha	___ graece νύμφη   sponsa puella ___   in mythologia graeca est creatura divina formam feminae nubilis gerens saepe loco quodam conexa sunt seu solitariae sive sectatrices deorum inter quos dionysi hermis panis et dearum saepius artemidis 
periculum	___ est condicio qua damnum vel iniuria fieri potest fere idem significans ac discrimen 
laboratorium	___ aut officina experimentis agendis est officina ad investigationes scientifica et technologiae rerum naturalium parata saepe in universitatibus aut scholis constituta 
italia	___ rite res publica italica italiane repubblica italiana est unitaria respublica parlamentaria in europa meridiana sita 
argentaria	___ societas est vel collegium ubi pecunia ab aliis mutua sumitur et aliis mutua datur 
mores	___ sunt actiones consuetudines et usus qui inter homines instituti sunt ut sibi suisque quisque morigeratur ac circa locorum organismorumque vicissitudinibus obtemperare possit 
hungaria	___ vel ungaria hungarice magyarország   terra hungarica   est res publica in europa 
agesilaus	___ graece ἀγησίλαος est nomen graecum latine fere dux populorum significans 
planeta	___ olim stella errans est corpus caeleste in spatio situm 
fuga	___ est actus devitans cum hominibus tum ceteris animantibus periculis minis aliisque incommodis inlatus 
electum	___ francogallice alet les bains est commune francicum 431 incolarum anno 2010 praefecturae atacis in regione australi occitania et ruscinone 
constans	flavius iulius ___ dictus ___ natus inter annos 320 et 323 obiit mense februario 350 in gallia australi apud illiberim francice elne ultimus filius constantini magni et faustae fuit ab anno 337 usque ad mortem imperator romanus 
athena	___ attice vel ionice dorice in poësi epica est in mythologia graeca virgo dea quae artes bellumque curavit metidis et iovis filia cuius ex capite vivens orta est 
dictatura	___ est imperium unius hominis qui saepe dictator nominatur etsi temporibus hodiernis ut mos est dictatores titulis formalibus legitimisque sicut duce praesidente rege plerumque utuntur 
abbreviatio	___ est forma brevior longioris alicuius verbi aut dictionis ex pluribus verbis constantis 
tributum	___ et vectigal sunt quod cives rei publicae solvere debent 
versus	___ a verbo vertere est poesi series numerorum more metrico dispositorum 
ventus	___ sensu lato est fluctus gasium saepissime tamen fluctus aeris in telluris enim superficie in amplo aeris motu consistit 
celeritas	___ est quam celer res movit mathematice magnitudo velocitatis rei unitatibus usitatis metrorum per secundum divisorum 
saxones	___ graece σάξονες fuerunt gens europaea quae litora germaniae incolebant claudio ptolemaeo teste 
biologia	___ est scientia naturalis quae vitam et organismos vivos describit et investigat ut eorum anatomia physiologia auctus origines propagatio et taxinomia sciantur systema vitae terrestris melius intellegatur melioria remedia reperiantur et agricultura proferatur 
filia	___ est puella vel femina quae est progenies ex coitu patris et matris genita aut per adoptionem in familiam recepta 
22	___ fuit calendarii iuliani annus communis die veneris incipiens annus consulatus agrippae et galbae nonus annus regni tiberii imperatoris annus 775 ab urbe condita 
chemia	___ sive chymia seu chimia est scientia multas in disciplinas divisa quae atomos describendo explicat quare et quomodo moleculae ex atomis formentur 
triumphus	___ est ritus quo victoriam imperator romanus iussu senatús celebravit 
achilles	___ fuit heros filius thetidis et pelei et pater pyrrhi aut neoptolemi 
al	in lingua arabica ___ est articulus definitus ut graecum ho ὁ et anglicum the 
petropolis	___ sive petroburgum seu petriburgum russice ad annum 1914 et ab anno 1991 санкт петербург sankt peterburg annis 1914 1924 петроград petrograd annis 1924 1991 ленинград leningrad est urbs   dignitatis foederalis   metropolis regionis leninopolitanae ленинградская область et districtus foederalis septentrio occidentalis северо западный федеральный округ russiae ad flumen nevam in capite sinus finnici prope mare balticum sita 
martium	___ italiane est oppidum italiae et municipium in regione bruttio et in provincia consentina situm 
visigothi	___ vel wisigothi gothice wisigutans vel wisjus litteris latinis 𐍅𐌹𐍃𐌹𐌲𐌿𐍄𐌰𐌽𐍃 vel 𐍅𐌹𐍃𐌾𐌿 𐍃 na t ivis apud g r aecos f ueru n t gens g e r manica o rien t alis par s gothorum q uae i nter sae c u la i v et v i ii euro p am in c olue r unt 
plurium	___ alia nomina prura etiam communitas plurii italiane est oppidum italiae et municipium circiter 2 000 incolarum in regione langobardia et in provincia sundriensi situm 
cuvaitum	___ arabice الكويت plenius emiratus kuvaitensis est civitas in parte septentrionali paeninsulae arabicae ad litus sinus persici sita cui vicinae arabia saudiana et iracia sunt 
memoria	___ stricto sensu est corporis facultas datorum compondendorum retinendorum et dein recuperandorum ac adhibendorum 
spes	___ est status qui desiderium exituum exoptatorum promovet qui ad eventus et condiciones in vita sui vel ad summam pertinent ut in locutione spero spem habeo te in inferis putrefacturum esse 
cognomen	___ est hominis nomen proprium romanorum tempore tertium post praenomen et nomen 
margarita	___ est calculiformis res dura intra carnem mollem mollusci vivi testam diserte amiculum gerentis genita 
professor	___ in plurimis civitatibus est praeceptor academicus in universitatibus aliisque institutis educationis postsecundariae et investigatoriae 
ethnos	___ est circulus hominum qui ipsi inter se per ligamina identificant quae eos ab aliis circulis distinguunt 
rhenus	___ est flumen in helvetia lichtenstenum austria germania francia et nederlandia 
nicaragua	___ rite respublica nicaraguae hispanice república de ___ est civitas sui iuris circiter 5 900 000 incolarum in america media sita 
glandula	___ graece ἀδήν aden est membrum corporis animalium et ergo hominis quod substantiam effert 
151	___ fuit calendarii iuliani annus communis die veneris incipiens annus consulatus condiani et valerii quintiliorum fratrorum annus 904 ab urbe condita 
festum	___ est res plerumque a commune monstrata in quadam illius communitatis proprietate unica et in eius traditionibus nitens saepe feriae dies festus mela vel eid loci vel nationis nota 
grana	___ italiane est oppidum italiae et municipium in regione pedemontio et in provincia astensi situm 
molecula	___ ae f est grex electrice neutrius partis duorum vel plurium atomorum a covalentibus vinculis chemicis cohibitorum 
anaunia	___ seu vallis ___ italiane val di non est vallis italiana in provincia libera tridentina 
gallus	___ ___ domesticus vulgo ___ est avis domesticata cladi galloanserarum et subspecies galli galli 
bellis	___ gen bellidis est regione plantarum regni plantarum florentium ordine asteralium familiae asteracearum 
murus	___ est structura quae aream definit onus fert saepe pars aedificii vel refugio vel securitati prodest 
hierosolyma	___ seu ierusalem hebraice arabice est urbs levantis in aequo montium iudaerum inter mare mediterraneum et mare mortuum sita 
ritus	___ est ordo quo constitutum est quo modo caerimoniae plerumque religiosae exsequendae sint 
helvetia	___ sive confoederatio helvetica est respublica foederalis quae in pagis vel cantonibus sex et viginti consistit 
lucretius	titus ___ carus c 99 55 a c n fuit poëta romanus qui in poëmate de rerum natura longo carmine didactico hexametricis versibus doctrinam physicam epicuri exposuit 
suecia	___ alia nomina latina svecia svetia et svedia suecice est civitas scandinavica in europa septentrionali sita cuius terra lingua latina classica nomine suevia appellabatur 
maritima	___ etiam maritma alia nomina maritimus ager italiane est historica ac geographica terra italiae 
comoedia	___ a graeco κωμῳδία κώμη   vicus   κῶμος   exsultatio   ᾠδή   cantus   sensu hodierno est sermo vel opus scriptum quod plerumque oblectationi vel festivitati per risum inductum dicatur praecipue in theatro televisione pellicula et ___ stante 
data	___ ex dando sunt indicia cruda vel infecta vel intacta saepe arti informaticae et statisticae propria quae etiam in aliis disciplinis psychologia biologia etc magno usui sunt 
silesia	___ est regio europae mediae quae primo millennio imprimis a slavis culta est 
digesta	___ etiam pandectae a graeco πανδέκτης omnia amplectens dicta sunt compilatio ex operibus causidicorum romanorum et fontem et copia et pondere summum iuris romani praebent vide corpus iuris civilis 
paeninsula	___ ae f vel peninsula vel paeneinsula paene insula est regio terrae quae in corpus aquae tendat sicut natio italica 
missa	___ quae in novo testamento dominica cena aut fractio panis appellatur est celebratio eucharistiae ut nominatur in latinis ecclesiae catholicae romanae ritibus in ecclesiis catholicis veteribus in anglo catholico anglicanismi usu et in nonnullis regionibus lutheranis civitatibus scandinaviis balticisque non exclusis 
samoa	___ samoane sāmoa publice libera civitas samoana anglice independent state of ___ est res publica quae occidentalem insularum samoanarum partem gubernat in oceano pacifico meridiano et quattor habitatas insulas comprehendit quae sunt upolu savaii manono et apolima 
paroecia	___ vel parochia in variis ecclesiis christianis est parvus districtus qui ecclesiam parochialem habet et a parocho sive sacerdote presbytero ministro administratur 
ovum	___ est in multis reptilibus cellula ___ a masculo fecundata quam scientiati zygotum ex verbo graeco ζυγωτόν appellant 
13	annus aerae vulgaris seu annus domini ___ fuit annus communis die solis incipiens 
civilitas	___ polítice política ae f res ars política res civiles administratio reipublicae civitatis est disciplina scientifica quae civitatis iurum rectionum rerumque publicarum naturam investigat regulas moresque civiles et systemata politica comparans 
dantes	___ italiane dante est praenomen masculinum forma brevis nominis durantis italiane durante 
ferrariae	___ italiane sunt oppida italiae et municipia in regione aemilia romania et in provincia placentina situm 
corsica	___ francice corse italiane ___ est insula in mari mediterraneo et regio franciae hodiernae diu praefecturam singulam constituens recenter in duas praefecturas divisum videlicet ___ superior et meridionalis 
christus	___ graece χριστός   unctus   quo rex vel sacerdos unguitur in christianismo est cognomentum iesu 
latium	___ italiane lazio est regio administrativa italiae circiter 5 870 451 incolarum in italia media sita cuius urbs maxima et capitalis est roma 
archipelagus	___ initio dicebatur aut mare aegaeum omne aut ea pars in qua plurimae insulae reperiuntur 
influentia	___ vel influenza vel grippa vel grippus vel febris catarrhalis epidemica est morbus vel accuratius pestilentia sive viralis infectio epidemica quae provocatur a diversis viris familiae orthomyxoviridarum quae attingunt aves et mammalia 
patruus	___ est patris cuiusdam frater et avunculus est matris frater 
lacum	___ alia nomina lacus italiane est oppidum italiae et municipium in regione bruttio et in provincia consentina situm 
linguistica	___ sive plenius ___ generalis etiam glottologia est scientia quae quaslibet linguas naturales pertractat quali vocum sive gestuum verborum sententiarum significationumque structura constitutae sint 
spatium	___ i n sensu latissimo est separatio inter duas aut plures res quae per multas mensuras quantificatur 
guinea	___ rite respublica guineae francice république de guinée est civitas sui iuris in africa occidentali cuius terra antiqua nomine graeco latino classico hesperia plerumque cognita est 
eboracum	___ sive eburacum anglice york est urbs angliae in isuria septentrionali ad ripas ousae et fossae sita quae fere ducenta milia incolarum habet 
passa	___ catalane paçà est commune francicum 693 incolarum anno 2012 praefecturae pyrenaei orientalis in regione australi occitania et ruscinone a die 1 ianuarii 2016 occitania ruscinone meridiano et pyrenaeis 
terentius	___ fuit nomen gentilicium romanum aetatibus posterioribus est praenomen masculinum 
scandinavia	___ est regio geographica linguistica et historico culturalis europae septentrionalis 
austria	___ theodisce österreich ex forma vetere ostarrichi est res publica foederalis in media europa sita 
stilus	___ rarius graphium graece erat instrumentum scriptorium ferreum vel aeneum quo in ceratis tabulis veteres scribebant quod ab una parte acuminatum erat ad litteras formandas ab altera obtusum et planum ad delendum si opus esset quod scriptum fuerat et ceram rursus complanandam 
satura	___ scilicet   ___ lanx   significat primo sensu vas cibi vel fructuum variorum plenum 
thema	___ lingua graeca θέμα est divisio administrativa militaris imperii byzantini 
chilia	___ seu chile ita et hispanice plenius res publica chile est civitas in america meridionali 
anima	___ secundum plurimas religiones et doctrinas philosophicas est principium vitale vel essentia se noscens cum corpore viventi consociata de mortuo autem fortasse decedens 
constantius	___ romanum fuit et etiam est cognomen quod e constante venit eandemque significationem tenet quae est firmus 
tiberius	___ fuit praenomen virile romanum litteris ti vel tib notatum primum fortasse cognomen quod significabat eum qui iuxta tiberim habitat 
autonomia	___ graece αυτονομια αυτο   sui   νομος   lex   est potestas humana motu proprio dominari absque iussu seu potestate alterius vel suo iure in negotia propria optare cum libertate receptoque 
culturae	___ francogallice couture sur loir est commune francicum 411 incolarum anno 2012 praefecturae liderici et cari in provincia centri et valle ligeris 
russi	___ sive rutheni russice русские tr russkie est gens slavica orientalis gentium slavicarum numerosissima 
farina	___ est proventus frumenti terendi et praecipue tritici aestivi panis principium vel etiam tritici duri pastae principium seu farris necnon speltae 
ossa	___ litteris graecis neograece interdum κίσσαβος cissabus 1 978 metris altus est mons thessaliae in graecia 
antoninus	___ fuit cognomen vel agnomen romanum hodie est praenomen masculinum 
tuscia	___ seu nomine antiquo etruria italiane toscana est regio administrativa italiae circiter 3 750 511 incolarum in italia media sita cuius caput est florentia 
volatus	___ est phaenomenon per quod animal vel res in aere suspenditur vi in altum petente 
actor	___ est proprie et primo qui aliquid ut pecus cf ἀγέλη bestias cf ἄγρα homines cf agmen ante se pellit 
scotia	___ anglice scotland gadelice alba est civitas quae pars britanniarum regni est et in septentrionali insulae magnae britanniae parte tertia consistit 
gnaeus	___ eiusdem originis ut naevus fuit praenomen virile romanum litteris cn notatum de quo quintilianus scripsit quid quae scribuntur aliter quam enuntiantur nec   ___   eam litteram in praenominis nota accipit qua sonat 
educatio	___ est ratio discendi doctrinam disciplinam et artes per cursum vitae 
iudex	___ est qui decernit utrum reus criminis accusatus innocens sit an non aut lites civiles decernit 
phoenix	___   cis m e graeca φοινιξ in mythologia est avis nobilis in arabia vel graeca vel aegypta auri fulgore circa colla cetera purpureus caeruleam roseis caudam pennis distinguentibus 
annus	___ est spatium temporis quo planeta errans circum solem suum a puncto quodam ad idem punctum movetur 
apulia	___ italiane puglia atque olim puglie graece ἰαπυγία iapygia est regio administrativa italiae meridianae circiter 4 090 266 incolarum cuius fines sunt ad septentrionem molisio ad meridionem mare ionium ad orientem mare hadriaticum ad occidentem basilicata et campania 
peregrinus	___ vel peregrina est homo qui ex alia terra venit et nunc in alia terra vivit 
prosa	___ oratio ___ vel prorsa etymo pro versa i e   quae procedit usque ad finem lineae   est oratio soluta scilicet metro soluta ac libera 
circulus	___ in geometria euclideana est simplex forma quae ex punctis in plano descriptis constat quae pari intervallo quod radius r vocatur a dato puncto centro appellato distant 
victus	___ seu ___ cottidianus est quilibet cibus per totum fere annum in horreo vel apotheca retinendus ad omnem fere cenam inferendus et a quodam populo communiter adhibitus 
aristoteles	___ litteris graecis ἀριστοτέλης 384 a c n 322 a c n fuit philosophus graecus discipulus platonis magister alexandri magni 
additio	___ onis f est operatio arithmetica qua describitur summa quantitatumve quarundam 
intellegentia	___ ab intellegendo multis modis variis definitur inter quos humana logicae comprehensionis cognitionis sui eruditionis scientiae animi motus destinationis creativitatis quaestionumque respondendarum facultas 
patronus	apud antiquos romanos ___ erat consularis vir optimo genere natus qui auxilium ferebat municipiis et hominibus qui ei magistratus petenti favebant e clientes vocabantur 
reditus	___ est consumptionis partorumque potestas quam aliquis quovis tempore acquisivit saepe ad res argentarias spectans 
museis	___ alia nomina musei villa de prato italiane sarde est oppidum italiae et municipium in regione sardinia in provincia carboniensi ecclesiensi ac in agro sulcitano ecclesiensi historica ac geographica terra sita 
hibernia	___ hibernice éire est insula in oceano atlantico sita magnitudine insularum britannicarum altera hodie inter duas civitates divisa scilicet 
melodia	___ ex graeco μελῳδία   cantus   vel melos poet laxe cantus carmen modi orum pl numeri orum pl vox atque tantum linea et pars est linearis tonorum musicorum successio quae ut res singula percipi potest 
cibus	___ est quaelibet res ad praebendum nutritionale corporis animalis adiumentum consumpta quae plerumque in plantis vel animalibus oritur et nutrimenta necessaria continet sicut carbohydrata adipes proteina vitamina et mineralia 
euripides	___ graece c 480 406 a c n fuit poëta tragicus graecus natu minimus ex tribus illustrissimis tragoedis atheniensibus 
augur	___ is m vir est qui auctoritate publicâ sacras aves alit custodit atque observat et ex iis futura divinat 
adamus	___ sive adam m indeclinabile est praenomen masculinum quod ex adam venit bibliis pristino homine cuius nomen hebraice terram significat 
arabia	___ arabice العربية al arabiya est paeninsula in asia austro occidentalis 
iaponia	___ notis iaponicis 日本 latinis nihon vel nippon publice 日本国 vel nippon koku   civitas iaponiae   est civitas sui iuris in occidentali oceano pacifico sita ubi permultas prope sinas coream russiam insulas tenet atque administrat praeter orientale asiae litus continentalis et a mari ochotensi septentrionibus ad mare sinense orientale et sinas quae inter meridiem et occidentem solem spectant patet 
liquidum	___ est liquor vel umor qui comprimi paene non potest et se ad formam eius receptaculi accommodat volumen autem paene constans retinens a pressura liberum 
plutarchus	___ chaeroneus 46 p c n ca 122 fuit auctor graecus sacerdosque delphicus 
interrete	___ prima littera maiuscula is n aut rete informaticum is n anglice est computatrorum maximorum rete quod plurima alia retia connectit 
nauta	___ est homo qui vasa aquatica navigat aut eorum effectioni conservationi vel usui auxiliat 
digitalis	___ est genus circa viginti specierum fruticum herbacearum partim perennium partim biennium 
iugoslavia	___ etiam dicta austroslavia antiquitate illyricum fuit civitas sui iuris europaea dicioni terrarum slavicarum subiecta 
lituania	___ seu lithuania est civitas sui iuris prope orientale maris baltici litus una ex tribus civitatibus balticis inter scandinaviam russiam et europam orientalem 
iulia	___ est nomen gentis romanae ad quem gaius iulius caesar pertinebat temporibus recentioribus est praenomen femininum 
functio	___ in arte mathematica est congruentia inter duas copias quae ad quodque elementum primae copiae unum elementum secundae copiae destinat 
lupus	___ binomen canis ___ a linnaeo anno 1758 statutum est carnivorum familiae canidarum et progenitor canum domesticorum 
evangelium	___ a graeco εὐαγγέλιον   bonum nuntium   est bonum de iesu christo nuntium et salvatio ab eo inventa 
caesar	___ cognomen gentis iuliae fuit post octavianum augustum titulus principum romanorum temporibus recentioribus etiam praenomen
britanni	___ orum m pl in medio aevo brittones onum appellati fuerunt natio celtica quae in britannia vixerunt multis in tribubus constantes e quibus cambri sive wallenses caledones hodierni e caledoniis antiquis cum scotis hibernigenis commixtis angli hodierni e britanniae propriae pristinis incolis cum anglis saxonibus commixti nati sunt 
fifa	foederatio pedilusoria internationalis ___ francogallice fédération internationale de football association est foederatio moderatrix pediludii pediludii aularis et pediludii litoralis orbis terrarum 
aqua	___ chemice oxidum hydrogenii et hydrogenium oxydatum rite appellata est compositum chemicum cuius formula chemica est ho 
appius	___ fuit praenomen virile romanum saepe in gente claudia adhibitum 
beda	___ apud posteros sanctus ___ venerabilis anglice the venerable bede natus anno 672 aut 673 mortuus die 26 maii 735 fuit anglicus ordinis benedictinorum monachus theologus presbyterque monasterii northumbriensis apostolorum petri et pauli quod ad viuraemudam wearmouth et gyruum situm erat 
moenia	___ n pl sing moene haud adhibitum latine est murus circum urbem oppidum aut magnum castrum statutus ut oppugatores defendantur 
habitatio	___ est regio oecologica vel ambitalis quam certa animalium plantarum vel aliorum organismorum species habitat 
panis	___ est cibus antiquus hodiernusque quod ex frumento molito in furno ex farina aqua et usitate sale fit 
codex	___ primum fuit solum arboris truncus aut ligni later sed hodie hoc vocabulo praecipue dicitur liber rectangulariter formatus saeculo primo in europa excogitatus volumen surrogans 
armenia	___ armeniace հայաստան hayastan rite res publica ___ հայաստանի հանրապետություն hayastani hanrapetut yun est civitas sui iuris in eurasiae montibus inter pontum euxinum et mare caspium in meridiana parte montium caucasiorum sita 
neapolis	___ etiam parthenope et palaepolis alia nomina neapolitana civitas sichem sicima urbs vergiliana urbs virgiliana urbs italice neapolitane est urbs italica et municipium circiter 977 530 incolarum locus princeps regionis campaniae et caput urbis metropolitanae neapolitanae 
fines	___ francogallice feins gallonice feins britonice finioù est commune 788 incolarum anno 2008 praefecturae illae et vicinoniae in franciae occidentalis regione britannia minore 
problema	___ graece πρόβλημα ad litteram proiectum significans est quaelibet quaestio solvenda 
canada	___ sive raro canadia est civitas sui iuris in america septentrionali sita spatio secunda maxima mundi post russiam 
omnia	___ sunt totum universum quod exsistit contrarium vel complementum nihilius totalitas rerum quae ad certam rem subiectam spectant 
membrum	___ est artus corporis hominis vel animalis nomen generale et bracchium et crus comprehendens 
orta	___ alia nomina ___ nova sive castrum ortae hortua italiane est oppidum italiae et municipium circiter 17 950 incolarum in regione apulia ac in provincia fodiana situm 
ludovica	___ suecice est urbs sueciae 14 498 incolarum anno 2010 in dalecarlia provincia apud lacum barken sita 
philosophia	___ etymologice   amor sapientiae   graece φιλεῖν   amare   σοφία   sapientia   est studium sapientiae vel veritatis per investigationem principiorum cogitationis humanorumque factorum 
crimaea	___ russice крым ucrainice крим tatarice crimensi къырым qırım seu chersonesus taurica est paeninsula in parte septentrionali ponti euxini maris nigri etiam a palude maeotide mari asoviensi a septentrio oriente alluetur 
telescopium	___ graece tele skopion pro skopos est instrumentum quodlibet seu ferramentum quod res longe distantes videre sinit 
statua	___ est sculptura quae creaturas depingit sicut hominem atque animal 
massachusetta	___ sive massachuseta vel massaciusseta rite respublica massachusettensis anglice commonwealth of massachusetts vel respublica massachusettensium est civitas civitatum foederatarum americae 
wolfgangus	___ est praenomen virile germanicum a wolf   lupus   et gang   iter   deductum quod gesserunt inter alios sanctus ___ ratisbonensis et ___ amadeus mozart 
plantae	___ etiam viridiplantae appellatae iam vegetabilia et gignentia appellatae in biologia hodierna sunt multicellulares organismi vivi qui ad regnum plantarum pertinent in gregibus angiospermarum pinophytorum bryophytorum et pteridophytorum digesti atque secundum varias definitiones in gregibus chlorophytorum et charophytorum plantis marinis sicut rhodophyta et phaeophyceae atque fungis bacteriisque exceptis 
barbara	___ est nomen femininum quod originem graecam habet βάρβαρος barbarus et sibi peregrina seu fera vult 
hymnus	___ graece ὕμνος est cantus qui deum vel aliquem deum laudat 
nerva	marcus cocceius ___ 8 novembris 30 27 ianuarii 98 fuit imperator romanus ab 96 usque mortem suam 
ecclesiae	___ alia nomina episcopatus sulcitanus zulchae italiane sardice sunt urbs italiae et municipium circiter 27 300 incolarum in regionis et insula sardinia ac in agro sulcitano ecclesiensi historica ac geographica terra situm et caput cum carbonia provinciae carboniensis ecclesiensis 
suffragium	___ est expressionis comitiorum per optimum optionem decidere in arbitrio 
croatia	___ plenius res publica croatiae alia nomina chroaeia chroatia chrobatia croacia gruacia sive nomen antique liburnia croatice republika hrvatska est civitas europaea ad finem maris mediterranei mediae europae et balcaniae antiqui haemi iacens capite zagrabia antiquo andautonia 
cancellarius	___ in medio aevo clericus aulicus erat qui tabulas scribebat 
cerebrum	___ sive encephalon est systematis nervosi pars et centrum in homine ceterisque animalibus vertebratis ac plurimis invertebratis 
grammatica	___ est scientia et ars recte loquendi scribendique quae in linguarum praeceptis regulisque consistit subdisciplinas phonologiam morphologiam syntaximque complectens quae usum recte loquendi docent errores linguae describunt formas vocabulorum explicant et partes orationis linguae et regulas verba componendi demonstrant 
proelium	___ vel pugna est conflictus longinquus inter duos exercitus saepe pars belli 
lignum	___ est textura dura et fibrosa in multis arboribus inventa 
calor	___ in physica dicitur quantitas energiae in transitu quae simpliciter ob differentiam temperaturae fluit et quae neque labori nec materiae motu correspondet 
longus	___ sive longos graece lesbius fuit scriptor graecus antiquus qui fabulam notissimam nomine daphnis et chloe conscripsit 
infrastructura	___ simpliciter est pro societate vel pro officina vel pro aedificatione vel pro civitate ratio fundaminis transportationis communicationis telecommunicatioque et valetudinarii ac systema electrica aquae ducti sani gasi et cloacae fossa et interrete et cetera quae includet pontes moles purgamentium aliae aedificationes et alia quae munera vel occupationes vel professiones praebet 
filius	___ fem filia est progenies ex coitu patris et matris genitus aut per adoptionem in familiam receptus 
psychologia	___ est disciplina scientifica et practica in qua ratio mentis et morum cognoscitur 
lugdunum	___ francogallice est municipium 496 343 incolarum anno 2012 in francia 
aerarium	___ est camera in quolibet aedificio quae pecuniam gazam aliasque res pretiosas continere potest 
constitutio	___ est systema gubernandi saepe documentum scriptione digestum quod regulas et principia reipublicae vel societatis formae instituit 
imperium	___ sensu lato potest intellegi sicut potestas quod vocabulum antiquitus vero hominibus potest attinere in eo casu significans quasi statum potestatis vel auctoritatem vel in geographico modo siginificans fines seu territorium 
graeci	___ graece έλληνες sunt populus in europa et praesertim in graecia ubi est gens maxima sed etiam in aliis terris habitans 
iustitia	___ notio philosophiae quae moralis ethica rationalis legalis naturalis religiosa distributiva et aequalis quae et agit de suppliciis statuendis si quis iustitiae principia violet 
haitia	haiti sive ___ francogallice haïti haitiane ayiti est res publica maris caribaei occidentali in tertio hispaniolae sita 
mathematica	___ graece ἡ μαθηματική scil ἐπιστήμη sive τέχνη a voce μανθάνω   disco   sive mathematice sive mathesis dicitur doctrinalis scientia quae abstractam considerat quantitatem variis aspectibus qui sunt algebraica geometrica analytica 
chanatus	___ us m vocabulum turcicae originis est civitatem a chani gubernatam designans 
eu	___ est commune francicum 7 270 incolarum anno 2012 praefecturae sequanae maritimae in regione normannia superiori a die 1 ianuarii 2016 normannia 
pestis	___ sive pestilentia est morbus cuius causa est bacterium yersinia ___ quod anno 1894 inter contagium ___ hongkongi ab alexandro yersin medico repertum est 
facies	___ sive vultus etiam os est hominis et ceterorum mammalium pars anterior capitis 
gaius	___ interdum caius fuit praenomen romanum masculinum abbreviatio huius praenominis fuit c 
cuniculus	oryctolagus est genus monotypum animalium cuius sola species est oryctolagus ___ latinitate communi ___ 
dialogus	___ est sermo duorum aut plurium hominum qui de aliqua re vel quaestione inter se conloquuntur aut disceptant 
kansia	___ seu kansas est civitas civitatum foederarum americae urbe capitali topeca urbe maxima wichita 
missionarius	___ a missione est sodalis cuiusdam religionis qui ceteros religionis aliae convertere ad propriam temptaret 
bacterium	___ e graeco βακτήριον   parvum baculum   est dominium biotum vitalium quod solum ex una cellula constat et nucleum non habet 
opinio	___ est status mentis ad rem veram cogitandum vel quisque propria cogitatio 
thailandia	___ thai ประเทศไทย prathet thai scil regnum populi thai olim siamum est civitas sui iuris in media paeninsula indosinensi asiae austro orientalis sita birmaniam laotiam cambosiam ac malaesiam attingens 
religio	___ sive res divinae rum f pl est ordinata systematum opinionum systematum culturae cosmotheoriarumque congeries quae humanitatem cum rebus sacris et aliquando moralitate coniungit 
radiophonia	___ sive ars radiophonica est technologia qua enuntiationes in primis hominum voces per undas radiophonicas transferre licet 
epocha	___ est mensura temporum seu terminus fixus a quo numerantur anni 
buddhismus	___ e verbo buddha   sapiens vigilatus   sive buddhae religio est corpus praeceptorum saepe religio habitum vel tantum modus vivendi qui circa saeculum sextum a c n in india ortus est 
fauna	___ animalium specierum globus est quae geographicam regionem incolunt quae aevi geologici propria sunt aut quae in quodam oecosystemate inveniri possunt 
vocalis	___ secundum definitionem phoneticam sonus est cuiuslibet linguae articulatae nam animalium soni nec vocales nec consonantes sunt in cuius pronuntiatu meatus vocis apertus est ita ut flumen aeris ex pulmonibus efflatum expedite sineque obstructione per os exeat 
requiem	___ est verbum primum introitus missae pro defunctis ac exsequialis ___ aeternam dona eis domine 
pinacotheca	___ sive pinacothece graece a   tabula   et   repositorium   est locus in aedibus amplus vel totum aedificium pictis tabulis et imaginibus exornatum 
composita	___ francogallice la compôte est commune 224 incolarum anno 2008 praefecturae sabaudiae in franciae orientalis regione rhodano et alpibus 
nundinae	___ sunt conventus mercatorum emptorumque seriatim per annum celebratae in oppidis italiae antiquae nono quoque die in europa hodierna praesertim septimo in partibus africae et asiae quinto quoque die 
interpretatio	___ sive versio vel minus saepe translatio est textus ex una lingua in aliam versus vel actio textus vertendi 
vehiculum	___ a vehendo est machina mobilis quae ad onera ex alio loco in alium transportanda adhibetur 
citrus	___ i f a nomine graeco i e cedrus est genus arborum fructiferarum in familia rutacearum 
caecilius	___ fuit nomen gentilicium romanum nunc in variis linguis praenomen adhibetur 
latus	___ italiane est fluvius italicus qui per apuliam regionem 5 chiliometra patet 
italica	___ fuit oppidum antiquum a publio cornelio scipione africano maiore anno 206 a c n secundo bello punico prope hispalim hodie sevilla et praesentem urbem hispanicam santiponce conditum 
epaminondas	___ graece επαμεινώνδας natus anno incerto mortuus 362 a c n fuit ductor exercitus et magistratus thebanus cuius praesantissimum ingenium tam in bellicis quam in civilibus rebus causa fuit cur illius patria per decem annos 371 362 a c n principatum totius graeciae a graecis hegemoniam appellatam obtinuerit 
vitis	___ nomen botanicum a linnaeo anno 1753 statutum est genus plantarum florentium cuius fructús uvae appellantur 
theatrum	___ i n est locus vel aedificium ubi actores tragoedias dramata ludos scaenicos atque comoedias agunt 
ore	___ est commune francicum 123 incolarum anno 2012 praefecturae garunnae superioris in regione australi meridiano et pyrenaeis a die 1 ianuarii 2016 occitania ruscinone meridiano et pyrenaeis 
cuba	___ est maxima antillarum magnarum insula in mari caribaeo insularum americanarum magnitudine quarta totius terrarum orbis autem quindecima 
quinquaginta	___ numeris arabicis 50 romanis l graecis νʹ est numerus naturalis et par inter 49 et 51 
islandia	___ seu terra glacialis islandice ísland terra gelida ipa ˈislant est insula et civitas in oceano atlantico inter groenlandiam norvegiam scotiam insulas faroenses et hiberniam sita 
nummus	___ i m medium est ad pecuniam solvendam ergo ad commercium faciendum et bona accipienda 
caelum	___ est locus superior ac pars atmosphaerae cuius usque ad finem mundi se contingit 
langobardia	___ seu longobardia italiane lombardia est regio italiae incolis 10 023 876 in italia septentrionali inter alpes sinistramque padi fluminis ripam sita 
promunturium	___ seu promontorium dicitur terra prominens quae vel in mari prominet vel supra terras circumiectas elevatur 
aves	___ sunt classis animalium vertebratorum homoeothermorum bipedum oviparorum ossibus cavis alis et pennis saepe ornatis 
coffeum	___ turcice kahve ex arabico قهوة qahwa   vinum fabae   cafaeum cafea cafeum caffeum cofeum coffea vel potus arabicus   etc est potio infusa e seminibus assatis et molitis quae saepius fabae appellantur arboris generis coffeae 
ephemeris	___ graece ἐφημερίς ab ἐπὶ   in   et ἡμέρα   dies   est liber in quo res gestae per singulos dies scribuntur 
donum	___ est id quod hominibus ex animi liberalitate datur et pecuniâ non compensatur quamquam donator aliquando dona futura exspectat 
ostia	___ vel ___ antiqua italiane est xxxv pars romae in agro romano cuius signum est z 
sebastianus	___ est nomen virile a nomine sebastiae aut sebastes urbium asiae minoris deductum 
gnu	___ anglice gnu s not unix   ___ unix non est   est systema administrativum computatrale quae libertatis ex pretio causa factum ut similis systemati unix sit 
narratio	___ est describendi genus quo res sive gestae sive fictae sermone aut scriptura efferuntur 
ur	___ sumerice urim accadice uru arabice أور fuit urbs civitas sumerica antiqua in mesopotamia sita accuratius in loco hodierno tell el muqayyar in provincia dhi qar natione iracum sita 
praefectura	___ est divisio administrativa in multis civitatibus hodiernis et antiquis adhibita 
theogonia	___ graece est carmen cuius auctor hesiodus circa annum 700 a c n floruit graeceque composuit 
deserta	___ orum npl sive desertum sive vasta solitudo   inis f sive solitudo vel regio ___ est loca quae minimam praecipitationem accipit minus quam satis ut plurimae plantae supersint 
receptum	___ italiane est oppidum italiae et municipium in regione pedemontio et in provincia novariensi situm 
historia	___ a verbo graeco ἱστορία   indagatio scientia per explorationem parta   est exploratio rerum praeteritarum praecipue autem de afflictionibus actionibus praeteritis ad homines 
venetiae	___ sive venetiarum civitas italiane venezia venete venesia vel venessia sunt urbs italiae et municipium circiter 264 580 incolarum 
vallis	in geologia ___ vel convallis est cavus cum exsuperat quatenus in unum directionem inter montes vel colles 
cyclus	___ graece κύκλος vocantur eventus qui certis temporis spatiis vel periodis revertunt 
angelopolis	___ vulgo los angeles est maxima californiae urbs et civitatum foederatarum secunda urbe novo eboraco locum primum tenente 
pharmacocinetica	___ pars pharmacologia substantiarum vires in organismo investigat et describit 
technologia	___ a graeca antiqua τέχνη   ars   λογία   e studio   λόγος   studium   est materia instrumentum ratio ars et astutia quae pro optima productione necessaria est atque vectura usuque bonorum 
centurio	___ fuit miles in exercitu romano qui centum milites duxit 
philippi	___ graece fuit urbs antiqua macedoniae orientalis a philippo ii anno 356 a c n conditum et e nomine suo appellatum 
monasterium	___ est aedificium ubi monachi vel monachae vivunt et laborant 
famosus	___ est homo insignis quasi lumen firmamenti socialis cuius personalitas late recognita populum aliquantulum in quotidianis nuntiorum mediis fascinat et movet 
fides	___ est confidentia vel fiducia hominis rei deitatis vel doctrinis religionis vel opinionis 
abbatia	___ est monasterium sui iuris cui abbas vel abbatissa praeest 
oraculum	___ ab orando sensu amplificato est omnis ratio tempora futura per res praeternaturales indagandi 
basilicae	___ alia nomina castrum basilicis italiane sunt oppida italiae et municipia in regione campania in provincia beneventana et in samnio historica ac geographica regione sita 
oedipus	___ graece in mythologia graeca fuit filius laii et iocastae 
samuel	___ sive samuhel hebraice ש מו א ל graece σαμουήλ est praenomen virile originis hebraicae quod vel nomen dei vel auditum a deo significat 
clementina	___ est grex varietatum arborum fructiferarum quae ad genus citrorum pertinent 
pelvis	___ 02 5 02 001 est regionis anatomica truncum inferioris inter abdomen et crures 
umbria	___ est regio administrativa italiae circiter 896 742 incolarum in italia media sita cuius caput est perusia 
sultanus	___ seu soldanus arabice sulṭān primum potentiam imperium significans est supremus princeps vel imperator nationis islamicae 
belgica	___ sive belgium est regnum in europa occidentali situm in limite culturae inter europam latinam et germanicam 
asteroides	___ a vocabulo graeco i e   stellae similis   e verbo   stella   et suffixo adiectivo   similis   vel etiam planetoides i e   planetae similis   est corpus caeleste parvum solidumque quod gyrum ellipticum circum stellam agit 
virtus	___ graece ἀρετή est quaedam morum dispositio qua ad recte vivendum homines commoventur 
ulla	___ alia nomina ula oppidum ullae italiane est oppidum italiae et municipium in regione sardinia et in provincia aristianensi arborensi situm 
angulus	___ in geometria est figura a duobus radiis finem communem habentibus verticem appellatum formata 
iulianum	___ alia nomina iuellanellum iullanum olim fortasse leirianum italiane est urbs italiae et municipium circiter 123 170 incolarum in regione campania et in urbe metropolitana neapolitana situm 
pagus	___ a prima origine   terminus in terram pactus   cf pango ex antiquitate vocatur quaequam regio geographica cuius fines lege aut foedere defixi sunt 
bithynia	___ graece βιθυνία nomen est antiquae regionis anatoliae septentrionalis vel turciae hodiernae 
vulnus	___ est laesio quaedam animalis qua textus vel integumentum vel membrana mucosa dividitur vel rumpitur aut ob vim externam calamitatem vel elementum mechanichum aut ob morbum 
carbo	___ onis m est materia nigra quae magna parte in carbonio consistit 
metrum	___ graece μέτρον via francogallice mètre est mensura principalis anglice base unit longitudinis una ex septem principalibus physicae mensuris in internationali unitarum systemate anglice international system of units 
byzantium	___ graece est urbs ad extremitatem europae austro orientalem et ad ora bospori a megariis saeculo septimo a c n colonizata 
bolivia	___ plenius res publica boliviae est respublica in america australi sita 
zingari	___ zygeni zigeuni zigani gittani vel bohemi sive cingari sive acingani sive atsingani sive aegyptii aegyptiaci vel hamaxobii qui hodie saepissime romanes vulgo romanì et rom vocantur populus variis e gentibus compositus sunt 
explorator	___ etiam emissarius et speculator anglice scout spy in exercitu romano temporibus antiquis fuit miles vel homo non militaris qui hostium itineribus locisque exploratis ducibus romanis inventa deferebat 
moyses	___ seu moses hebraice מ ש ה pronuntiatu hodierno moshe tiberiano mōšéh iso 259 3 moše graece mωϋσῆς seu mωσῆς arabice موسى mūsa secundum biblia hebraica et alcoranum fuit dux religiosus vir legifer et propheta cui auctoritas torah usitate attribuitur 
wii	___ est quinta consola lusoria opera nintendo in commercium inducta et septima progenies una cum playstation 3 et xbox 360 
metropolis	___ est urbs magis vel area urbana qua est magni momenti locus oeconomicus rei publicae et culti ad civitatem vel regionem et situs gravis ad commercium 
phaenomenon	___ sive phaenomenum graece φαινόμενον φαίνομαι   appareo videor   est res mundi quae fit et perceptione cognoscitur 
demarchus	___ i m graece ad litteram archon demi valens multis in civitatibus magistratus maximi gradus est in communali sive municipali gubernatione aut in buleuterio oppidi vel magnae urbis 
rolandus	___ hruodlandus rotholandus aut rodlanus 778 francogallice et anglice roland vasconice errolan hispanice roldán fuit miles et dux francorum qui sub imperio caroli magni fuit brittannici sic limitis praefectus vel marchio 
emmanuel	___ graece ab hebraico   nobiscum deus   brevius manuel est nomen virile quod in libro isaiae et evangelio secundum matthaeum reperitur 
atmosphaera	___ ex graeco ἀτμός   vapor   σφαῖρα   sphaera   est gas iuxta astri superficiem vi gravitate retentum sicut ___ telluris 
templum	___ primum fuit vel spatium aliquod certum et apertum praecipue auguriis designatum ideoque sacrum ut tradit vocem extemplo explicans servius extemplo ilico statim est 
natalis	___ scilicet dies sive more graeco genethliacus est dies festus in quo nascitur et qui quotannis saepe cum familia vel amicis celebratur crustulum comedendo et dona ferendo 
votum	in religionibus ___ est pollicitatio alicui deo vel deae facta alicuius rei optatae invicem impetrandae gratia ita ductores exercituum romanorum medio proelio templum vel ludos divinitati cuidam vovere solebant a qua auxilium et victoriam impetrarent 
metallica	___ est grex musicus qui grave metallum et verberans metallum cantat 
caligula	gaius iulius caesar germanicus breviter gaius caesar dictus ___ 12 41 fuit princeps romanus 
iosephus	___ vel ioseph est praenomen masculinum ex hebraico יו ס ף iosef 
cyrus	___ erat nomen proprium persicum et hodie est praenomen italicum italiane ciro 
aequatio	___ est sententia mathematica quae dicit duas quantitates esse aequas 
organizatio	___ est generatim structura cuiusdam institutionis socialis id est administrationis collegii consociationis ecclesiae factionis ordinis reipublicae senatus societatis sodalicii sodalitatis cett 
negotium	___ est omne quod homines quaestus causa agunt quod contrarium est otio et beneficentiae 
cornu	___ est rigida acutaque prominentia ossea aut ceratinea quae ex capite bestiarum aliquarum praesertim artiodactylorum consurgit 
corona	___ est capitis seu collis cinctura e foliis floribusque plecta quae apud multos populos in feriis et ad celebrandum adhibetur 
heros	___ gen herois m femininum herois gen heroidis vel heroine gen heroines e verbo graeco ἥρως olim apud graecos significabat semideum iunctionem dei hominisque 
longitudo	___ est quantitas physica fundamentalis quae etiam in sermone cotidiano spatium indicat quod inter quaspiam res distantes est 
aemilianus	___ 207 aut 213 253 ultimo vitae suae anno caesar factus est 
oriens	___ est caeli regio unde sol oritur ideo etiam ortus appellatur 
bohemia	___ olim boiohaemum et nonnunquam czechia bohemice čechy theodisce böhmen polonice czechy anglice ___ est regio nunc ad cechiam pertinens 
polonia	___ polonice polska publice res publica polonica rzeczpospolita polska est civitas sui iuris in europa media sita quae a germania ad solis occasum cechia et slovacia ad meridianum ucraina ruthenia alba et lithuania ad solis ortum atque mari baltico et regione kaliningradensi russiae ad septentriones cingitur 
athleta	___ est homo ad hunc finem exercitatus ut in arte athletica vincat sive quam optime succedat 
vacuum	___ ex vacuo in sermone quotidiano est copia anglice volume spatii quod reapse est corpus inane ut sua pressio gaseosa sit multo minus quam pressio atmosphaerica 
experientia	___ refertur ad cognitiones facultates artes satis multis experimentis periculisque adquisitas quarum ope in variis operibus conficiendis feliciter procedere possumus 
caeruleus	___ a um est color maris alti atque caeli cum sit sudum 
diaeta	___ graece δίαιτα est modus vivendi a medico praescriptus praecipue ad cibum pertinens 
paradoxum	___ est dictum quod contra ratiocinationem quae gravis ex principiis veris apparet ad finem ducit qui se contradicit aut absurdus est 
coitus	___ sive synusia seu mixis est modus copulationis et actus sexualis 
hierarchia	___ graece ἱεραρχία ἱερός ἀρχή est systema elementorum quae sibi invicem super vel subordinata sunt 
geometria	___ graece γεωμετρία γεω   terra   μετρία   mensura   est disciplina mathematica quae quantitates spatiales considerat magnitudines formas et coniunctiones inter eas 
palatina	___ alia nomina paladina italiane est oppidum italiae et municipium circiter 4 000 incolarum in regione langobardia et in provincia bergomati situm 
imago	___ ut dicit forcellini est simulacrum species exemplar alicuius rei repraesentatio 
conductor	___ ___ operis conductrix operis redemptor redemptrix ergolabus i m vel susceptor operum in oeconomia est homo qui operarios vel potius laborem operariorum vel operam faciendam conducit 
foederatio	___ sive civitas foederalis civitas diversis entitatibus territorialibus autonomis composita est quae propriam gubernationem habent et generatim civitates nuncupantur 
aedificium	___ vel aedes est opus humanum usitate ab aedificatoribus constructum tecto ostiis et fenestris atque ex ligno lapide ferro vel alia materia praeditum 
mensura	___ est modus vel consequentia decretae rationis quantitatis physicae sicut longitudo tempus et temperatura ad unitatem mensurae sicut metrum et secundus et gradus celsii 
anulus	___ est circulus ex auro sive alio metallo pretioso confectum ad digitos ornandos 
canticum	___ anglice show tune est carmen populare pro ludo musico compositum praecipue tale carmen extra ludum cantum et argumento originale separatum 
ioannes	___ sive iohannes est nomen masculinum originis hebraicae vide ___ nomen 
inventor	___ est homo magni ingenii qui instrumentum facit quod numquam in hominum mente prius conceptum est 
parlamentum	___ curia est publicorum hominum conventus in quo de legibus cum potestate legifera deliberatur et res de aerarii usu custodit 
auctoritas	___ temporibus romae antiquae fuit notio describens quantum vir in rebus rei publicae gerendis valeat 
finium	___ seu finum alia nomina ___ mornascum finum mornascum italiane est oppidum italiae et municipium circiter 9 600 incolarum in regione langobardia et in provincia novocomensi situm 
alia	___ italiane est oppidum et municipium italicum in provincia regionali panormitana regionis siciliae situm 
unesco	___ acronymum ex verbis anglicis united nations educational scientific and cultural organization formatum sive unitarum nationum educationis scientiae culturae ordo vel societas cultui humanitatique provehendis est organizatio internationalis et simul una ex septendecim societatibus peculiaribus consociationis nationum cui sedes est lutetiae in francia 
odium	___ est animi motus qui sensus animositatis irae vel stomachi invocare potest ut certos homines greges entitates res mores notiones vel ideas petiant 
piscis	___ est quaelibet animal vertebratum aquatileque squamis binis pinnarum coniunctarum copiis et nonnullis pinnis non coniunctis praeditum 
turcia	___ turcice türkiye rite res publica turcica turcice türkiye cumhuriyeti est res publica eurasiana in asia occidentali praecipue in paeninsula anatoliana et in thracia orientali in europa austrorientali sita 
geologia	___ a graeco   terra     ratio   est scientia quae investigationem telluris solidi lapidum in quibus terra consistit et rationes quibus evolvitur comprehendit 
antiquitas	___ est aevum antiquum quod a primis rebus gestis scriptura mandatis usque ad medium aevum pertinet 
alcohol	___ is m indecl m is n a nomine arabico الكحل al kuḥl est liquor sine colore qui fermentatione in fructuum suco facta exsistit quique cum est potus ebrietatem in hominibus et animalibus efficit 
fetus	___ in vita humana est homo antenatalis inter stationem embryonicam et partum 
decimus	___ fuit praenomen virile romanum littera d notatum quod in gente claudia solis patriciis sed apud iunios et laelios plebi quoque dabatur 
culpa	___ ut scribit aegidius forcellini est labes macula noxa quae ex malefactis oritur peccantemque reum iacit ac reprehensione et poena dignum item universim delictum peccatum omissio officii 
comitia	___ sunt ratio per quam circulus unum inter suos sodales ad obeundum munus per suffragium designat 
rai	___ vel pleniter radiotelevisione italiana   radiotelevisio italiana   est societas televisifica publica italiana 
